facility_name,report_date,daily_output_samples_tested,daily_output_unique_individuals,daily_output_positive_individuals,daily_output_negative_individuals,daily_output_equivocal,daily_output_invalid,remaining_available_tests,backlogs,cumulative_samples_tested,cumulative_unique_individuals,cumulative_positive_individuals,cumulative_negative_individuals,pct_positive_cumulative,pct_negative_cumulative,validation_status
Allegiant Regional Care Hospital,2020-05-13,20,20,9,11,,,120,,20,20,9,11,0.45,0.55,
Allegiant Regional Care Hospital,2020-05-14,20,20,11,9,,,60,,40,40,20,20,0.5,0.5,
Allegiant Regional Care Hospital,2020-05-15,0,0,0,0,,,60,,40,40,20,20,0.5,0.5,
Allegiant Regional Care Hospital,2020-05-16,20,20,8,12,0,0,20,,60,60,28,32,0.47,0.53,
Allegiant Regional Care Hospital,2020-05-17,0,0,0,0,0,0,20,,60,60,28,32,0.47,0.53,
Allegiant Regional Care Hospital,2020-05-18,20,20,4,16,0,0,0,,80,80,32,48,0.4,0.6,
Allegiant Regional Care Hospital,2020-05-19,0,0,0,0,0,0,0,71,80,80,32,48,0.4,0.6,
Allegiant Regional Care Hospital,2020-05-20,0,0,0,0,0,0,40,138,80,80,32,48,0.4,0.6,
Allegiant Regional Care Hospital,2020-05-21,40,40,5,35,0,0,600,98,120,120,37,83,0.31,0.69,
Allegiant Regional Care Hospital,2020-05-22,40,40,0,40,0,0,580,100,160,160,37,123,0.23,0.77,
Allegiant Regional Care Hospital,2020-05-23,0,0,0,0,0,0,560,100,160,160,37,123,0.23,0.77,
Allegiant Regional Care Hospital,2020-05-24,0,0,0,0,0,0,560,100,160,160,37,123,0.23,0.77,
Allegiant Regional Care Hospital,2020-05-25,40,40,6,34,0,0,520,95,200,200,43,157,0.21,0.79,
Allegiant Regional Care Hospital,2020-05-26,40,40,0,40,0,0,480,92,240,240,43,197,0.18,0.82,
Allegiant Regional Care Hospital,2020-05-27,61,61,10,51,0,0,420,69,301,301,53,248,0.18,0.82,
Allegiant Regional Care Hospital,2020-05-28,40,40,2,38,0,0,380,40,341,341,55,286,0.16,0.84,
Allegiant Regional Care Hospital,2020-05-29,40,40,2,38,0,0,340,40,381,381,57,324,0.15,0.85,
Allegiant Regional Care Hospital,2020-05-30,0,0,0,0,0,0,340,40,381,381,57,324,0.15,0.85,
Allegiant Regional Care Hospital,2020-05-31,0,0,0,0,0,0,340,40,381,381,57,324,0.15,0.85,
Allegiant Regional Care Hospital,2020-06-01,38,38,3,35,0,0,300,7,419,419,60,359,0.14,0.86,
Allegiant Regional Care Hospital,2020-06-02,0,0,0,0,0,0,300,17,419,419,60,359,0.14,0.86,
Allegiant Regional Care Hospital,2020-06-03,40,40,3,37,0,0,260,40,459,459,63,396,0.14,0.86,
Allegiant Regional Care Hospital,2020-06-04,39,39,8,31,0,0,220,47,498,498,71,427,0.14,0.86,
Allegiant Regional Care Hospital,2020-06-05,59,59,4,55,0,0,160,46,557,557,75,482,0.13,0.87,
Allegiant Regional Care Hospital,2020-06-06,0,0,0,0,0,0,160,50,557,557,75,482,0.13,0.87,
Allegiant Regional Care Hospital,2020-06-07,0,0,0,0,0,0,160,50,557,557,75,482,0.13,0.87,
Allegiant Regional Care Hospital,2020-06-08,61,61,10,51,0,0,100,18,618,618,85,533,0.14,0.86,
Allegiant Regional Care Hospital,2020-06-09,41,41,10,31,0,0,60,30,659,659,95,564,0.14,0.86,
Allegiant Regional Care Hospital,2020-06-10,60,60,10,50,0,0,20,40,719,719,105,614,0.15,0.85,
Allegiant Regional Care Hospital,2020-06-11,0,0,0,0,0,0,60,60,719,719,105,614,0.15,0.85,
Allegiant Regional Care Hospital,2020-06-12,60,60,10,50,0,0,0,53,779,779,115,664,0.15,0.85,
Allegiant Regional Care Hospital,2020-06-13,0,0,0,0,0,0,0,60,779,779,115,664,0.15,0.85,
Allegiant Regional Care Hospital,2020-06-14,0,0,0,0,0,0,0,60,779,779,115,664,0.15,0.85,
Allegiant Regional Care Hospital,2020-06-15,0,0,0,0,0,0,0,60,779,779,115,664,0.15,0.85,
Allegiant Regional Care Hospital,2020-06-16,62,61,12,49,0,0,19,60,841,840,127,713,0.15,0.85,
Allegiant Regional Care Hospital,2020-06-17,59,59,10,49,0,0,380,60,900,899,137,762,0.15,0.85,
Allegiant Regional Care Hospital,2020-06-18,61,61,18,43,0,0,320,140,961,960,155,805,0.16,0.84,
Allegiant Regional Care Hospital,2020-06-19,60,60,11,49,0,0,260,180,1021,1020,166,854,0.16,0.84,
Allegiant Regional Care Hospital,2020-06-20,0,0,0,0,0,0,260,255,1021,1020,166,854,0.16,0.84,
Allegiant Regional Care Hospital,2020-06-21,0,0,0,0,0,0,260,255,1021,1020,166,854,0.16,0.84,
Allegiant Regional Care Hospital,2020-06-22,80,80,25,55,0,0,180,260,1101,1100,191,909,0.17,0.83,
Allegiant Regional Care Hospital,2020-06-23,79,79,35,44,0,0,20,190,1180,1179,226,953,0.19,0.81,
Allegiant Regional Care Hospital,2020-06-24,0,0,0,0,0,0,20,60,1180,1179,226,953,0.19,0.81,
Allegiant Regional Care Hospital,2020-06-25,0,0,0,0,0,0,2500,200,1180,1179,226,953,0.19,0.81,
Allegiant Regional Care Hospital,2020-06-26,,,,,,,,,1180,1179,226,953,0.19,0.81,
Allegiant Regional Care Hospital,2020-06-27,,,,,,,,,1180,1179,226,953,0.19,0.81,
Asian Hospital and Medical Center,2020-05-16,46,45,5,40,0,0,4462,,46,45,5,40,0.11,0.89,
Asian Hospital and Medical Center,2020-05-17,0,0,0,0,0,0,0,,46,45,5,40,0.11,0.89,
Asian Hospital and Medical Center,2020-05-18,27,25,3,22,0,0,6000,,73,70,8,62,0.11,0.89,
Asian Hospital and Medical Center,2020-05-19,27,27,2,25,0,0,6000,0,100,97,10,87,0.1,0.9,
Asian Hospital and Medical Center,2020-05-20,36,34,3,31,0,2,6000,0,136,131,13,118,0.1,0.9,
Asian Hospital and Medical Center,2020-05-21,48,48,0,48,0,0,6000,0,184,179,13,166,0.07,0.93,
Asian Hospital and Medical Center,2020-05-22,49,49,0,49,0,0,6000,0,233,228,13,215,0.06,0.94,
Asian Hospital and Medical Center,2020-05-23,,,,,,,,,233,228,13,215,0.06,0.94,
Asian Hospital and Medical Center,2020-05-24,10,10,2,8,0,0,6000,0,243,238,15,223,0.06,0.94,
Asian Hospital and Medical Center,2020-05-25,60,58,1,57,0,2,6100,0,303,296,16,280,0.05,0.95,
Asian Hospital and Medical Center,2020-05-26,34,34,3,31,0,0,6100,0,337,330,19,311,0.06,0.94,
Asian Hospital and Medical Center,2020-05-27,48,40,0,40,0,8,9500,0,385,370,19,351,0.05,0.95,
Asian Hospital and Medical Center,2020-05-28,91,42,4,38,0,49,9500,0,476,412,23,389,0.06,0.94,
Asian Hospital and Medical Center,2020-05-29,59,57,0,57,0,2,9550,0,535,469,23,446,0.05,0.95,
Asian Hospital and Medical Center,2020-05-30,47,32,1,31,0,15,9550,0,582,501,24,477,0.05,0.95,
Asian Hospital and Medical Center,2020-05-31,0,0,0,0,0,0,9550,0,582,501,24,477,0.05,0.95,
Asian Hospital and Medical Center,2020-06-01,46,20,0,20,0,3,9550,0,628,521,24,497,0.05,0.95,
Asian Hospital and Medical Center,2020-06-02,59,59,1,58,0,0,9350,0,687,580,25,555,0.04,0.96,
Asian Hospital and Medical Center,2020-06-03,55,55,0,55,0,0,9350,0,742,635,25,610,0.04,0.96,
Asian Hospital and Medical Center,2020-06-04,54,52,1,51,0,2,9350,0,796,687,26,661,0.04,0.96,
Asian Hospital and Medical Center,2020-06-05,66,60,1,59,0,6,9350,0,862,747,27,720,0.04,0.96,
Asian Hospital and Medical Center,2020-06-06,42,40,1,39,0,2,9350,0,904,787,28,759,0.04,0.96,
Asian Hospital and Medical Center,2020-06-07,0,0,0,0,0,0,5650,22,904,787,28,759,0.04,0.96,
Asian Hospital and Medical Center,2020-06-08,48,46,2,44,0,2,5450,0,952,833,30,803,0.04,0.96,
Asian Hospital and Medical Center,2020-06-09,36,36,4,32,0,0,5250,0,988,869,34,835,0.04,0.96,
Asian Hospital and Medical Center,2020-06-10,64,62,2,60,0,2,5150,0,1052,931,36,895,0.04,0.96,
Asian Hospital and Medical Center,2020-06-11,34,34,1,33,0,0,5150,0,1086,965,37,928,0.04,0.96,
Asian Hospital and Medical Center,2020-06-12,36,36,1,35,0,0,5150,0,1122,1001,38,963,0.04,0.96,
Asian Hospital and Medical Center,2020-06-13,29,28,3,25,0,1,5150,0,1151,1029,41,988,0.04,0.96,
Asian Hospital and Medical Center,2020-06-14,0,0,0,0,0,0,5000,0,1151,1029,41,988,0.04,0.96,
Asian Hospital and Medical Center,2020-06-15,51,50,0,50,0,1,4950,0,1202,1079,41,1038,0.04,0.96,
Asian Hospital and Medical Center,2020-06-16,43,43,0,43,0,0,4900,0,1245,1122,41,1081,0.04,0.96,
Asian Hospital and Medical Center,2020-06-17,75,70,2,68,0,5,4800,0,1320,1192,43,1149,0.04,0.96,
Asian Hospital and Medical Center,2020-06-18,42,41,2,39,0,1,4700,0,1362,1233,45,1188,0.04,0.96,
Asian Hospital and Medical Center,2020-06-19,60,59,3,56,0,1,4700,0,1422,1292,48,1244,0.04,0.96,
Asian Hospital and Medical Center,2020-06-20,71,70,9,61,0,1,4700,0,1493,1362,57,1305,0.04,0.96,
Asian Hospital and Medical Center,2020-06-21,2,2,0,2,0,0,4700,0,1495,1364,57,1307,0.04,0.96,
Asian Hospital and Medical Center,2020-06-22,87,83,3,80,0,3,4550,0,1582,1447,60,1387,0.04,0.96,
Asian Hospital and Medical Center,2020-06-23,88,70,4,66,0,3,4550,0,1670,1517,64,1453,0.04,0.96,
Asian Hospital and Medical Center,2020-06-24,110,109,4,105,0,1,4350,0,1780,1626,68,1558,0.04,0.96,
Asian Hospital and Medical Center,2020-06-25,157,156,6,150,0,1,4350,0,1937,1782,74,1708,0.04,0.96,
Asian Hospital and Medical Center,2020-06-26,107,105,8,97,0,1,4346,0,2044,1887,82,1805,0.04,0.96,
Asian Hospital and Medical Center,2020-06-27,127,104,2,102,0,7,4346,0,2171,1991,84,1907,0.04,0.96,
Baguio General Hospital and Medical Center,2020-04-03,134,131,2,129,,,4363,,608,600,21,579,0.04,0.96,
Baguio General Hospital and Medical Center,2020-04-04,179,176,3,173,,,4163,,787,776,24,752,0.03,0.97,
Baguio General Hospital and Medical Center,2020-04-05,159,157,1,156,,,3988,,946,933,25,908,0.03,0.97,
Baguio General Hospital and Medical Center,2020-04-06,25,25,0,25,,,3958,,971,958,25,933,0.03,0.97,
Baguio General Hospital and Medical Center,2020-04-07,182,181,2,179,,,3758,,1153,1139,27,1112,0.02,0.98,
Baguio General Hospital and Medical Center,2020-04-08,184,181,5,176,,,3538,,1337,1320,32,1288,0.02,0.98,
Baguio General Hospital and Medical Center,2020-04-09,91,87,0,87,,,3418,,1428,1407,32,1375,0.02,0.98,
Baguio General Hospital and Medical Center,2020-04-10,82,82,2,80,,,3318,,1510,1489,34,1455,0.02,0.98,
Baguio General Hospital and Medical Center,2020-04-11,190,185,1,184,,,3178,,1700,1674,35,1639,0.02,0.98,
Baguio General Hospital and Medical Center,2020-04-12,276,270,1,269,,,2773,,1976,1944,36,1908,0.02,0.98,
Baguio General Hospital and Medical Center,2020-04-13,45,41,0,41,,,2708,,2021,1985,36,1949,0.02,0.98,
Baguio General Hospital and Medical Center,2020-04-14,216,214,6,208,,,2443,,2237,2199,42,2157,0.02,0.98,
Baguio General Hospital and Medical Center,2020-04-15,81,78,0,78,,,2338,,2318,2277,42,2235,0.02,0.98,
Baguio General Hospital and Medical Center,2020-04-16,136,132,0,132,,,2163,,2454,2409,42,2367,0.02,0.98,
Baguio General Hospital and Medical Center,2020-04-17,330,321,0,321,,,1763,,2784,2730,42,2688,0.02,0.98,
Baguio General Hospital and Medical Center,2020-04-18,206,199,0,199,,,1763,,2990,2929,42,2887,0.01,0.99,
Baguio General Hospital and Medical Center,2020-04-19,184,178,0,178,,,1275,,3174,3107,42,3065,0.01,0.99,
Baguio General Hospital and Medical Center,2020-04-20,144,141,1,140,,,1100,,3318,3248,43,3205,0.01,0.99,
Baguio General Hospital and Medical Center,2020-04-21,190,186,0,186,,,885,,3508,3434,43,3391,0.01,0.99,
Baguio General Hospital and Medical Center,2020-04-22,93,92,0,92,,,735,,3601,3526,43,3483,0.01,0.99,
Baguio General Hospital and Medical Center,2020-04-23,453,7,7,0,,,3185,,4054,3533,50,3483,0.01,0.99,
Baguio General Hospital and Medical Center,2020-04-24,301,278,8,270,,,2885,,4355,3811,58,3753,0.02,0.98,
Baguio General Hospital and Medical Center,2020-04-25,250,225,10,215,,,2550,,4605,4036,68,3968,0.02,0.98,
Baguio General Hospital and Medical Center,2020-04-26,391,355,5,350,,,2100,,4996,4391,73,4318,0.02,0.98,
Baguio General Hospital and Medical Center,2020-04-27,466,370,0,370,,,1510,,5462,4761,73,4688,0.02,0.98,
Baguio General Hospital and Medical Center,2020-04-28,321,287,0,287,,,1110,,5783,5048,73,4975,0.01,0.99,
Baguio General Hospital and Medical Center,2020-04-29,415,371,3,368,,,560,,6198,5419,76,5343,0.01,0.99,
Baguio General Hospital and Medical Center,2020-04-30,567,551,1,550,,,0,,6765,5970,77,5893,0.01,0.99,
Baguio General Hospital and Medical Center,2020-05-01,0,0,0,0,,,0,,6765,5970,77,5893,0.01,0.99,
Baguio General Hospital and Medical Center,2020-05-02,93,93,0,93,,,2840,,6858,6063,77,5986,0.01,0.99,
Baguio General Hospital and Medical Center,2020-05-03,185,167,0,167,,,2620,,7043,6230,77,6153,0.01,0.99,
Baguio General Hospital and Medical Center,2020-05-04,190,176,0,176,,,2390,,7233,6406,77,6329,0.01,0.99,
Baguio General Hospital and Medical Center,2020-05-05,279,241,0,241,,,2080,,7512,6647,77,6570,0.01,0.99,
Baguio General Hospital and Medical Center,2020-05-06,235,178,0,178,,,1780,,7747,6825,77,6748,0.01,0.99,
Baguio General Hospital and Medical Center,2020-05-07,267,256,0,256,,,1480,,8014,7081,77,7004,0.01,0.99,
Baguio General Hospital and Medical Center,2020-05-08,46,43,0,43,,,1420,,8060,7124,77,7047,0.01,0.99,
Baguio General Hospital and Medical Center,2020-05-09,261,260,0,260,,,7120,,8321,7384,77,7307,0.01,0.99,
Baguio General Hospital and Medical Center,2020-05-10,432,424,1,423,,,6630,,8753,7808,78,7730,0.01,0.99,
Baguio General Hospital and Medical Center,2020-05-11,775,766,2,764,,,5750,,9528,8574,80,8494,0.01,0.99,
Baguio General Hospital and Medical Center,2020-05-12,602,595,1,594,,,5090,,10130,9169,81,9088,0.01,0.99,
Baguio General Hospital and Medical Center,2020-05-13,53,53,1,52,,,5025,,10183,9222,82,9140,0.01,0.99,
Baguio General Hospital and Medical Center,2020-05-14,758,744,0,744,,,4075,,10941,9966,82,9884,0.01,0.99,
Baguio General Hospital and Medical Center,2020-05-15,377,192,0,192,,,3300,,11318,10158,82,10076,0.01,0.99,
Baguio General Hospital and Medical Center,2020-05-16,377,174,0,174,0,0,2600,,11695,10332,82,10250,0.01,0.99,
Baguio General Hospital and Medical Center,2020-05-17,296,239,2,237,0,0,2200,,11991,10571,84,10487,0.01,0.99,
Baguio General Hospital and Medical Center,2020-05-18,147,145,0,145,0,0,1650,,12138,10716,84,10632,0.01,0.99,
Baguio General Hospital and Medical Center,2020-05-19,375,369,0,369,0,0,1400,0,12513,11085,84,11001,0.01,0.99,
Baguio General Hospital and Medical Center,2020-05-20,253,234,0,234,0,0,750,0,12766,11319,84,11235,0.01,0.99,
Baguio General Hospital and Medical Center,2020-05-21,316,259,0,259,0,0,450,0,13082,11578,84,11494,0.01,0.99,
Baguio General Hospital and Medical Center,2020-05-22,396,320,0,320,0,74,17204,0,13478,11898,84,11814,0.01,0.99,
Baguio General Hospital and Medical Center,2020-05-23,330,304,0,304,0,0,16754,0,13808,12202,84,12118,0.01,0.99,
Baguio General Hospital and Medical Center,2020-05-24,243,223,0,223,0,4,16354,0,14051,12425,84,12341,0.01,0.99,
Baguio General Hospital and Medical Center,2020-05-25,338,252,0,252,0,4,15954,0,14389,12677,84,12593,0.01,0.99,
Baguio General Hospital and Medical Center,2020-05-26,277,276,0,276,0,0,15654,0,14666,12953,84,12869,0.01,0.99,
Baguio General Hospital and Medical Center,2020-05-27,233,233,0,233,0,0,19406,0,14899,13186,84,13102,0.01,0.99,
Baguio General Hospital and Medical Center,2020-05-28,246,245,0,245,0,1,15084,0,15145,13431,84,13347,0.01,0.99,
Baguio General Hospital and Medical Center,2020-05-29,189,189,0,189,0,0,14864,0,15334,13620,84,13536,0.01,0.99,
Baguio General Hospital and Medical Center,2020-05-30,386,386,0,386,0,0,14534,0,15720,14006,84,13922,0.01,0.99,
Baguio General Hospital and Medical Center,2020-05-31,323,322,4,318,0,0,14174,0,16043,14328,88,14240,0.01,0.99,
Baguio General Hospital and Medical Center,2020-06-01,267,263,1,262,0,0,13874,0,16310,14591,89,14502,0.01,0.99,
Baguio General Hospital and Medical Center,2020-06-02,447,447,0,447,0,0,13574,0,16757,15038,89,14949,0.01,0.99,
Baguio General Hospital and Medical Center,2020-06-03,435,400,1,399,0,0,13024,0,17192,15438,90,15348,0.01,0.99,
Baguio General Hospital and Medical Center,2020-06-04,575,474,1,473,0,0,12374,0,17767,15912,91,15821,0.01,0.99,
Baguio General Hospital and Medical Center,2020-06-05,512,512,5,507,0,0,11524,0,18279,16424,96,16328,0.01,0.99,
Baguio General Hospital and Medical Center,2020-06-06,942,906,3,903,0,0,10524,0,19221,17330,99,17231,0.01,0.99,
Baguio General Hospital and Medical Center,2020-06-07,559,507,1,506,0,0,9874,0,19780,17837,100,17737,0.01,0.99,
Baguio General Hospital and Medical Center,2020-06-08,378,365,1,364,0,0,15474,0,20158,18202,101,18101,0.01,0.99,
Baguio General Hospital and Medical Center,2020-06-09,300,282,3,279,0,0,15124,0,20458,18484,104,18380,0.01,0.99,
Baguio General Hospital and Medical Center,2020-06-10,626,543,4,539,0,0,14763,0,21084,19027,108,18919,0.01,0.99,
Baguio General Hospital and Medical Center,2020-06-11,508,308,18,290,0,0,14084,0,21592,19335,126,19209,0.01,0.99,
Baguio General Hospital and Medical Center,2020-06-12,398,375,7,368,0,0,23584,0,21990,19710,133,19577,0.01,0.99,
Baguio General Hospital and Medical Center,2020-06-13,575,547,8,539,0,0,23584,0,22565,20257,141,20116,0.01,0.99,
Baguio General Hospital and Medical Center,2020-06-14,638,571,3,568,0,3,22941,0,23203,20828,144,20684,0.01,0.99,
Baguio General Hospital and Medical Center,2020-06-15,871,689,6,683,0,1,21991,0,24074,21517,150,21367,0.01,0.99,
Baguio General Hospital and Medical Center,2020-06-16,1351,1060,0,1060,0,0,20700,0,25425,22577,150,22427,0.01,0.99,
Baguio General Hospital and Medical Center,2020-06-17,890,798,7,791,0,0,18700,0,26315,23375,157,23218,0.01,0.99,
Baguio General Hospital and Medical Center,2020-06-18,635,550,0,550,0,0,17950,0,26950,23925,157,23768,0.01,0.99,
Baguio General Hospital and Medical Center,2020-06-19,813,756,1,755,0,0,16050,100,27763,24681,158,24523,0.01,0.99,
Baguio General Hospital and Medical Center,2020-06-20,783,670,0,670,0,0,16050,39,28546,25351,158,25193,0.01,0.99,
Baguio General Hospital and Medical Center,2020-06-21,647,633,0,633,0,0,15150,0,29193,25984,158,25826,0.01,0.99,
Baguio General Hospital and Medical Center,2020-06-22,619,534,0,534,0,1,14300,0,29812,26518,158,26360,0.01,0.99,
Baguio General Hospital and Medical Center,2020-06-23,788,635,0,635,0,0,21437,358,30600,27153,158,26995,0.01,0.99,
Baguio General Hospital and Medical Center,2020-06-24,696,606,4,602,0,0,20537,204,31296,27759,162,27597,0.01,0.99,
Baguio General Hospital and Medical Center,2020-06-25,1020,916,2,914,0,2,19037,0,32316,28675,164,28511,0.01,0.99,
Baguio General Hospital and Medical Center,2020-06-26,995,842,2,840,0,4,17537,0,33311,29517,166,29351,0.01,0.99,
Baguio General Hospital and Medical Center,2020-06-27,860,728,0,728,0,7,16577,0,34171,30245,166,30079,0.01,0.99,
Bataan General Hospital (RT PCR),2020-06-15,48,48,0,48,0,0,4940,0,48,48,0,48,0.0,1.0,
Bataan General Hospital (RT PCR),2020-06-16,0,0,0,0,0,0,4940,0,48,48,0,48,0.0,1.0,
Bataan General Hospital (RT PCR),2020-06-17,30,30,1,29,0,0,4900,0,78,78,1,77,0.01,0.99,
Bataan General Hospital (RT PCR),2020-06-18,60,60,1,59,0,0,4825,0,138,138,2,136,0.01,0.99,
Bataan General Hospital (RT PCR),2020-06-19,90,90,1,89,0,0,4715,0,228,228,3,225,0.01,0.99,
Bataan General Hospital (RT PCR),2020-06-20,105,105,0,105,0,0,4585,0,333,333,3,330,0.01,0.99,
Bataan General Hospital (RT PCR),2020-06-21,0,0,0,0,0,0,4585,0,333,333,3,330,0.01,0.99,
Bataan General Hospital (RT PCR),2020-06-22,60,60,0,60,0,0,4270,0,393,393,3,390,0.01,0.99,
Bataan General Hospital (RT PCR),2020-06-23,136,136,1,135,0,0,4120,0,529,529,4,525,0.01,0.99,
Bataan General Hospital (RT PCR),2020-06-24,108,108,0,108,0,0,3970,0,637,637,4,633,0.01,0.99,
Bataan General Hospital (RT PCR),2020-06-25,75,74,9,65,0,0,3865,0,712,711,13,698,0.02,0.98,
Bataan General Hospital (RT PCR),2020-06-26,91,90,0,90,0,0,3738,0,803,801,13,788,0.02,0.98,
Bataan General Hospital (RT PCR),2020-06-27,192,192,0,192,0,0,3508,0,995,993,13,980,0.01,0.99,
Bataan General Hospital and Medical Center GeneXpert Laboratory,2020-06-01,3,3,0,3,0,0,1174,0,3,3,0,3,0.0,1.0,
Bataan General Hospital and Medical Center GeneXpert Laboratory,2020-06-02,9,9,0,9,0,0,1165,0,12,12,0,12,0.0,1.0,
Bataan General Hospital and Medical Center GeneXpert Laboratory,2020-06-03,27,27,0,27,0,0,1131,0,39,39,0,39,0.0,1.0,
Bataan General Hospital and Medical Center GeneXpert Laboratory,2020-06-04,19,19,0,19,0,0,1111,0,58,58,0,58,0.0,1.0,
Bataan General Hospital and Medical Center GeneXpert Laboratory,2020-06-05,35,35,0,35,0,0,1076,0,93,93,0,93,0.0,1.0,
Bataan General Hospital and Medical Center GeneXpert Laboratory,2020-06-06,19,19,0,19,0,0,1056,0,112,112,0,112,0.0,1.0,
Bataan General Hospital and Medical Center GeneXpert Laboratory,2020-06-07,58,58,0,58,0,0,998,0,170,170,0,170,0.0,1.0,
Bataan General Hospital and Medical Center GeneXpert Laboratory,2020-06-08,36,36,0,36,0,0,962,0,206,206,0,206,0.0,1.0,
Bataan General Hospital and Medical Center GeneXpert Laboratory,2020-06-09,21,21,0,21,0,0,940,0,227,227,0,227,0.0,1.0,
Bataan General Hospital and Medical Center GeneXpert Laboratory,2020-06-10,86,86,1,85,0,0,852,0,313,313,1,312,0.0,1.0,
Bataan General Hospital and Medical Center GeneXpert Laboratory,2020-06-11,26,26,1,25,0,0,824,0,339,339,2,337,0.01,0.99,
Bataan General Hospital and Medical Center GeneXpert Laboratory,2020-06-12,15,15,0,15,0,0,809,0,354,354,2,352,0.01,0.99,
Bataan General Hospital and Medical Center GeneXpert Laboratory,2020-06-13,11,11,0,11,0,0,798,0,365,365,2,363,0.01,0.99,
Bataan General Hospital and Medical Center GeneXpert Laboratory,2020-06-14,6,6,0,6,0,0,792,0,371,371,2,369,0.01,0.99,
Bataan General Hospital and Medical Center GeneXpert Laboratory,2020-06-15,185,185,1,184,0,0,607,0,556,556,3,553,0.01,0.99,
Bataan General Hospital and Medical Center GeneXpert Laboratory,2020-06-16,55,55,1,54,0,2,549,0,611,611,4,607,0.01,0.99,
Bataan General Hospital and Medical Center GeneXpert Laboratory,2020-06-17,23,23,1,22,0,0,525,0,634,634,5,629,0.01,0.99,
Bataan General Hospital and Medical Center GeneXpert Laboratory,2020-06-18,34,34,0,34,0,0,491,0,668,668,5,663,0.01,0.99,
Bataan General Hospital and Medical Center GeneXpert Laboratory,2020-06-19,31,30,0,30,0,0,460,0,699,698,5,693,0.01,0.99,
Bataan General Hospital and Medical Center GeneXpert Laboratory,2020-06-20,36,36,0,36,0,0,424,0,735,734,5,729,0.01,0.99,
Bataan General Hospital and Medical Center GeneXpert Laboratory,2020-06-21,20,20,0,20,0,0,404,0,755,754,5,749,0.01,0.99,
Bataan General Hospital and Medical Center GeneXpert Laboratory,2020-06-22,29,29,0,29,0,0,375,0,784,783,5,778,0.01,0.99,
Bataan General Hospital and Medical Center GeneXpert Laboratory,2020-06-23,25,25,0,25,0,0,350,0,809,808,5,803,0.01,0.99,
Bataan General Hospital and Medical Center GeneXpert Laboratory,2020-06-24,22,22,0,22,0,0,328,0,831,830,5,825,0.01,0.99,
Bataan General Hospital and Medical Center GeneXpert Laboratory,2020-06-25,35,35,0,35,0,0,293,0,866,865,5,860,0.01,0.99,
Bataan General Hospital and Medical Center GeneXpert Laboratory,2020-06-26,51,51,2,49,0,0,842,0,917,916,7,909,0.01,0.99,
Bataan General Hospital and Medical Center GeneXpert Laboratory,2020-06-27,27,24,0,24,0,0,815,0,944,940,7,933,0.01,0.99,
Bicol Medical Center GeneXpert Laboratory,2020-05-28,31,27,0,27,0,4,329,0,31,27,0,27,0.0,1.0,
Bicol Medical Center GeneXpert Laboratory,2020-05-29,13,13,0,13,0,0,1516,0,44,40,0,40,0.0,1.0,
Bicol Medical Center GeneXpert Laboratory,2020-05-30,8,8,0,8,0,0,1505,0,52,48,0,48,0.0,1.0,
Bicol Medical Center GeneXpert Laboratory,2020-05-31,3,3,0,3,0,0,1502,0,55,51,0,51,0.0,1.0,
Bicol Medical Center GeneXpert Laboratory,2020-06-01,10,10,1,9,0,0,1492,0,65,61,1,60,0.02,0.98,
Bicol Medical Center GeneXpert Laboratory,2020-06-02,11,10,0,10,0,0,1481,0,76,71,1,70,0.01,0.99,
Bicol Medical Center GeneXpert Laboratory,2020-06-03,35,35,0,35,0,0,1409,0,111,106,1,105,0.01,0.99,
Bicol Medical Center GeneXpert Laboratory,2020-06-04,32,32,0,32,0,0,1414,0,143,138,1,137,0.01,0.99,
Bicol Medical Center GeneXpert Laboratory,2020-06-05,22,22,0,22,0,0,1392,0,165,160,1,159,0.01,0.99,
Bicol Medical Center GeneXpert Laboratory,2020-06-06,20,20,0,20,0,0,1372,0,185,180,1,179,0.01,0.99,
Bicol Medical Center GeneXpert Laboratory,2020-06-07,22,7,0,7,0,1,1350,0,207,187,1,186,0.01,0.99,
Bicol Medical Center GeneXpert Laboratory,2020-06-08,0,0,0,0,0,0,1350,0,207,187,1,186,0.01,0.99,
Bicol Medical Center GeneXpert Laboratory,2020-06-09,33,19,0,19,0,0,1317,0,240,206,1,205,0.0,1.0,
Bicol Medical Center GeneXpert Laboratory,2020-06-10,13,13,0,13,0,0,1544,0,253,219,1,218,0.0,1.0,
Bicol Medical Center GeneXpert Laboratory,2020-06-11,13,6,0,6,0,0,1531,0,266,225,1,224,0.0,1.0,
Bicol Medical Center GeneXpert Laboratory,2020-06-12,38,16,0,16,0,2,1493,0,304,241,1,240,0.0,1.0,
Bicol Medical Center GeneXpert Laboratory,2020-06-13,18,1,0,1,0,0,1476,0,322,242,1,241,0.0,1.0,
Bicol Medical Center GeneXpert Laboratory,2020-06-14,33,19,0,19,0,0,1442,0,355,261,1,260,0.0,1.0,
Bicol Medical Center GeneXpert Laboratory,2020-06-15,2,2,0,2,0,0,1440,0,357,263,1,262,0.0,1.0,
Bicol Medical Center GeneXpert Laboratory,2020-06-16,30,24,1,23,0,0,1410,0,387,287,2,285,0.01,0.99,
Bicol Medical Center GeneXpert Laboratory,2020-06-17,24,22,0,22,0,0,525,0,411,309,2,307,0.01,0.99,
Bicol Medical Center GeneXpert Laboratory,2020-06-18,20,20,0,20,0,0,1363,0,431,329,2,327,0.01,0.99,
Bicol Medical Center GeneXpert Laboratory,2020-06-19,7,7,0,7,0,0,1356,0,438,336,2,334,0.01,0.99,
Bicol Medical Center GeneXpert Laboratory,2020-06-20,28,26,0,26,0,0,1328,0,466,362,2,360,0.01,0.99,
Bicol Medical Center GeneXpert Laboratory,2020-06-21,2,2,0,2,0,0,1326,0,468,364,2,362,0.01,0.99,
Bicol Medical Center GeneXpert Laboratory,2020-06-22,17,14,0,14,0,0,1309,0,485,378,2,376,0.01,0.99,
Bicol Medical Center GeneXpert Laboratory,2020-06-23,27,18,0,18,0,4,1278,0,512,396,2,394,0.01,0.99,
Bicol Medical Center GeneXpert Laboratory,2020-06-24,49,35,0,35,0,0,1229,0,561,431,2,429,0.0,1.0,
Bicol Medical Center GeneXpert Laboratory,2020-06-25,32,23,2,21,0,0,1197,0,593,454,4,450,0.01,0.99,
Bicol Medical Center GeneXpert Laboratory,2020-06-26,40,39,0,39,0,0,1157,0,633,493,4,489,0.01,0.99,
Bicol Medical Center GeneXpert Laboratory,2020-06-27,44,43,5,38,0,0,1113,0,677,536,9,527,0.02,0.98,
Bicol Regional Diagnostic and Reference Laboratory (BRDRL),2020-04-08,34,34,2,32,,,5128,,62,59,2,57,0.03,0.97,
Bicol Regional Diagnostic and Reference Laboratory (BRDRL),2020-04-09,7,4,1,3,,,5116,,69,63,3,60,0.05,0.95,
Bicol Regional Diagnostic and Reference Laboratory (BRDRL),2020-04-10,0,0,0,0,,,5097,,69,63,3,60,0.05,0.95,
Bicol Regional Diagnostic and Reference Laboratory (BRDRL),2020-04-11,14,14,1,13,,,5097,,83,77,4,73,0.05,0.95,
Bicol Regional Diagnostic and Reference Laboratory (BRDRL),2020-04-12,0,0,0,0,,,5097,,83,77,4,73,0.05,0.95,
Bicol Regional Diagnostic and Reference Laboratory (BRDRL),2020-04-13,0,0,0,0,,,4854,,83,77,4,73,0.05,0.95,
Bicol Regional Diagnostic and Reference Laboratory (BRDRL),2020-04-14,26,25,1,24,,,4835,,109,102,5,97,0.05,0.95,
Bicol Regional Diagnostic and Reference Laboratory (BRDRL),2020-04-15,9,9,0,9,,,4816,,118,111,5,106,0.05,0.95,
Bicol Regional Diagnostic and Reference Laboratory (BRDRL),2020-04-16,15,15,0,15,,,4781,,133,126,5,121,0.04,0.96,
Bicol Regional Diagnostic and Reference Laboratory (BRDRL),2020-04-17,15,14,0,14,,,4700,,148,140,5,135,0.04,0.96,
Bicol Regional Diagnostic and Reference Laboratory (BRDRL),2020-04-18,34,34,6,28,,,4700,,182,174,11,163,0.06,0.94,
Bicol Regional Diagnostic and Reference Laboratory (BRDRL),2020-04-19,0,0,0,0,,,4700,,182,174,11,163,0.06,0.94,
Bicol Regional Diagnostic and Reference Laboratory (BRDRL),2020-04-20,0,0,0,0,,,4646,,182,174,11,163,0.06,0.94,
Bicol Regional Diagnostic and Reference Laboratory (BRDRL),2020-04-21,42,41,3,38,,,4587,,224,215,14,201,0.07,0.93,
Bicol Regional Diagnostic and Reference Laboratory (BRDRL),2020-04-22,38,32,6,26,,,4446,,262,247,20,227,0.08,0.92,
Bicol Regional Diagnostic and Reference Laboratory (BRDRL),2020-04-23,55,55,1,54,,,4360,,317,302,21,281,0.07,0.93,
Bicol Regional Diagnostic and Reference Laboratory (BRDRL),2020-04-24,27,27,0,27,,,4286,,344,329,21,308,0.06,0.94,
Bicol Regional Diagnostic and Reference Laboratory (BRDRL),2020-04-25,63,62,0,62,,,4216,,407,391,21,370,0.05,0.95,
Bicol Regional Diagnostic and Reference Laboratory (BRDRL),2020-04-26,25,25,0,25,,,4173,,432,416,21,395,0.05,0.95,
Bicol Regional Diagnostic and Reference Laboratory (BRDRL),2020-04-27,19,19,0,19,,,4108,,451,435,21,414,0.05,0.95,
Bicol Regional Diagnostic and Reference Laboratory (BRDRL),2020-04-28,48,44,3,41,,,4073,,499,479,24,455,0.05,0.95,
Bicol Regional Diagnostic and Reference Laboratory (BRDRL),2020-04-29,64,64,1,63,,,4857,,563,543,25,518,0.05,0.95,
Bicol Regional Diagnostic and Reference Laboratory (BRDRL),2020-04-30,46,46,3,43,,,4799,,609,589,28,561,0.05,0.95,
Bicol Regional Diagnostic and Reference Laboratory (BRDRL),2020-05-01,55,55,1,54,,,4694,,664,644,29,615,0.05,0.95,
Bicol Regional Diagnostic and Reference Laboratory (BRDRL),2020-05-02,64,64,3,61,,,4614,,728,708,32,676,0.05,0.95,
Bicol Regional Diagnostic and Reference Laboratory (BRDRL),2020-05-03,23,23,0,23,,,4583,,751,731,32,699,0.04,0.96,
Bicol Regional Diagnostic and Reference Laboratory (BRDRL),2020-05-04,61,61,1,60,,,4503,,812,792,33,759,0.04,0.96,
Bicol Regional Diagnostic and Reference Laboratory (BRDRL),2020-05-05,82,80,2,78,,,4383,,894,872,35,837,0.04,0.96,
Bicol Regional Diagnostic and Reference Laboratory (BRDRL),2020-05-06,30,30,1,29,,,4343,,924,902,36,866,0.04,0.96,
Bicol Regional Diagnostic and Reference Laboratory (BRDRL),2020-05-07,68,68,2,66,,,4303,,992,970,38,932,0.04,0.96,
Bicol Regional Diagnostic and Reference Laboratory (BRDRL),2020-05-08,96,96,6,90,,,4223,,1088,1066,44,1022,0.04,0.96,
Bicol Regional Diagnostic and Reference Laboratory (BRDRL),2020-05-09,58,58,1,57,,,4183,,1146,1124,45,1079,0.04,0.96,
Bicol Regional Diagnostic and Reference Laboratory (BRDRL),2020-05-10,31,31,2,29,,,4102,,1177,1155,47,1108,0.04,0.96,
Bicol Regional Diagnostic and Reference Laboratory (BRDRL),2020-05-11,62,62,1,61,,,3982,,1239,1217,48,1169,0.04,0.96,
Bicol Regional Diagnostic and Reference Laboratory (BRDRL),2020-05-12,88,88,1,87,,,3942,,1327,1305,49,1256,0.04,0.96,
Bicol Regional Diagnostic and Reference Laboratory (BRDRL),2020-05-13,63,61,2,59,,,3860,,1390,1366,51,1315,0.04,0.96,
Bicol Regional Diagnostic and Reference Laboratory (BRDRL),2020-05-14,60,59,2,57,,,3740,,1450,1425,53,1372,0.04,0.96,
Bicol Regional Diagnostic and Reference Laboratory (BRDRL),2020-05-15,93,89,0,89,,,3617,,1543,1514,53,1461,0.04,0.96,
Bicol Regional Diagnostic and Reference Laboratory (BRDRL),2020-05-16,0,0,0,0,0,0,3617,,1543,1514,53,1461,0.04,0.96,
Bicol Regional Diagnostic and Reference Laboratory (BRDRL),2020-05-17,0,0,0,0,0,0,3617,,1543,1514,53,1461,0.04,0.96,
Bicol Regional Diagnostic and Reference Laboratory (BRDRL),2020-05-18,0,0,0,0,0,0,3717,,1543,1514,53,1461,0.04,0.96,
Bicol Regional Diagnostic and Reference Laboratory (BRDRL),2020-05-19,,,,,,,,,1543,1514,53,1461,0.04,0.96,
Bicol Regional Diagnostic and Reference Laboratory (BRDRL),2020-05-20,0,0,0,0,0,0,3717,0,1543,1514,53,1461,0.04,0.96,
Bicol Regional Diagnostic and Reference Laboratory (BRDRL),2020-05-21,0,0,0,0,0,0,3717,,1543,1514,53,1461,0.04,0.96,
Bicol Regional Diagnostic and Reference Laboratory (BRDRL),2020-05-22,0,0,0,0,0,0,3717,0,1543,1514,53,1461,0.04,0.96,
Bicol Regional Diagnostic and Reference Laboratory (BRDRL),2020-05-23,0,0,0,0,0,0,13717,0,1543,1514,53,1461,0.04,0.96,
Bicol Regional Diagnostic and Reference Laboratory (BRDRL),2020-05-24,0,0,0,0,0,0,13717,0,1543,1514,53,1461,0.04,0.96,
Bicol Regional Diagnostic and Reference Laboratory (BRDRL),2020-05-25,0,0,0,0,0,0,13717,0,1543,1514,53,1461,0.04,0.96,
Bicol Regional Diagnostic and Reference Laboratory (BRDRL),2020-05-26,70,66,0,66,0,4,13637,0,1613,1580,53,1527,0.03,0.97,
Bicol Regional Diagnostic and Reference Laboratory (BRDRL),2020-05-27,97,97,1,96,0,0,14525,0,1710,1677,54,1623,0.03,0.97,
Bicol Regional Diagnostic and Reference Laboratory (BRDRL),2020-05-28,87,87,1,86,0,0,14365,0,1797,1764,55,1709,0.03,0.97,
Bicol Regional Diagnostic and Reference Laboratory (BRDRL),2020-05-29,122,122,1,121,0,0,14177,0,1919,1886,56,1830,0.03,0.97,
Bicol Regional Diagnostic and Reference Laboratory (BRDRL),2020-05-30,82,79,0,79,0,0,14057,0,2001,1965,56,1909,0.03,0.97,
Bicol Regional Diagnostic and Reference Laboratory (BRDRL),2020-05-31,0,0,0,0,0,0,14057,0,2001,1965,56,1909,0.03,0.97,
Bicol Regional Diagnostic and Reference Laboratory (BRDRL),2020-06-01,64,64,0,64,0,0,13950,0,2065,2029,56,1973,0.03,0.97,
Bicol Regional Diagnostic and Reference Laboratory (BRDRL),2020-06-02,59,59,0,59,0,0,13878,0,2124,2088,56,2032,0.03,0.97,
Bicol Regional Diagnostic and Reference Laboratory (BRDRL),2020-06-03,62,60,0,60,2,0,13798,0,2186,2148,56,2092,0.03,0.97,
Bicol Regional Diagnostic and Reference Laboratory (BRDRL),2020-06-04,50,50,0,50,0,0,12306,0,2236,2198,56,2142,0.03,0.97,
Bicol Regional Diagnostic and Reference Laboratory (BRDRL),2020-06-05,129,128,2,126,0,0,13469,0,2365,2326,58,2268,0.02,0.98,
Bicol Regional Diagnostic and Reference Laboratory (BRDRL),2020-06-06,130,111,0,111,0,0,13325,0,2495,2437,58,2379,0.02,0.98,
Bicol Regional Diagnostic and Reference Laboratory (BRDRL),2020-06-07,24,23,0,23,0,0,13305,0,2519,2460,58,2402,0.02,0.98,
Bicol Regional Diagnostic and Reference Laboratory (BRDRL),2020-06-08,0,0,0,0,0,0,13305,0,2519,2460,58,2402,0.02,0.98,
Bicol Regional Diagnostic and Reference Laboratory (BRDRL),2020-06-09,126,102,3,99,0,0,13141,0,2645,2562,61,2501,0.02,0.98,
Bicol Regional Diagnostic and Reference Laboratory (BRDRL),2020-06-10,119,112,0,112,0,2,12983,0,2764,2674,61,2613,0.02,0.98,
Bicol Regional Diagnostic and Reference Laboratory (BRDRL),2020-06-11,123,121,1,120,0,0,12831,0,2887,2795,62,2733,0.02,0.98,
Bicol Regional Diagnostic and Reference Laboratory (BRDRL),2020-06-12,128,125,1,124,0,1,12672,0,3015,2920,63,2857,0.02,0.98,
Bicol Regional Diagnostic and Reference Laboratory (BRDRL),2020-06-13,58,56,2,54,0,0,12551,0,3073,2976,65,2911,0.02,0.98,
Bicol Regional Diagnostic and Reference Laboratory (BRDRL),2020-06-14,0,0,0,0,0,0,12551,0,3073,2976,65,2911,0.02,0.98,
Bicol Regional Diagnostic and Reference Laboratory (BRDRL),2020-06-15,73,63,0,63,0,1,12456,0,3146,3039,65,2974,0.02,0.98,
Bicol Regional Diagnostic and Reference Laboratory (BRDRL),2020-06-16,88,87,0,87,1,0,12301,0,3234,3126,65,3061,0.02,0.98,
Bicol Regional Diagnostic and Reference Laboratory (BRDRL),2020-06-17,155,153,0,153,0,0,12113,0,3389,3279,65,3214,0.02,0.98,
Bicol Regional Diagnostic and Reference Laboratory (BRDRL),2020-06-18,116,91,1,90,0,1,11960,0,3505,3370,66,3304,0.02,0.98,
Bicol Regional Diagnostic and Reference Laboratory (BRDRL),2020-06-19,136,133,0,133,1,1,11778,0,3641,3503,66,3437,0.02,0.98,
Bicol Regional Diagnostic and Reference Laboratory (BRDRL),2020-06-20,99,84,1,83,0,0,11658,0,3740,3587,67,3520,0.02,0.98,
Bicol Regional Diagnostic and Reference Laboratory (BRDRL),2020-06-21,62,60,1,59,0,0,11578,0,3802,3647,68,3579,0.02,0.98,
Bicol Regional Diagnostic and Reference Laboratory (BRDRL),2020-06-22,16,16,1,15,0,0,11482,0,3818,3663,69,3594,0.02,0.98,
Bicol Regional Diagnostic and Reference Laboratory (BRDRL),2020-06-23,104,68,1,67,0,21,11176,0,3922,3731,70,3661,0.02,0.98,
Bicol Regional Diagnostic and Reference Laboratory (BRDRL),2020-06-24,160,147,0,147,0,0,10976,0,4082,3878,70,3808,0.02,0.98,
Bicol Regional Diagnostic and Reference Laboratory (BRDRL),2020-06-25,138,112,0,112,0,0,10672,0,4220,3990,70,3920,0.02,0.98,
Bicol Regional Diagnostic and Reference Laboratory (BRDRL),2020-06-26,143,142,1,141,0,1,10560,0,4363,4132,71,4061,0.02,0.98,
Bicol Regional Diagnostic and Reference Laboratory (BRDRL),2020-06-27,173,155,3,152,0,0,10428,0,4536,4287,74,4213,0.02,0.98,
Bulacan Medical Center GeneXpert Laboratory,2020-06-24,3,3,1,2,0,0,586,0,3,3,1,2,0.33,0.67,
Bulacan Medical Center GeneXpert Laboratory,2020-06-25,0,1,0,1,0,0,585,0,3,4,1,3,0.25,0.75,For Review
Bulacan Medical Center GeneXpert Laboratory,2020-06-26,0,0,0,0,0,0,0,0,3,4,1,3,0.25,0.75,
Bulacan Medical Center GeneXpert Laboratory,2020-06-27,1,1,0,1,0,0,584,0,4,5,1,4,0.2,0.8,
Cagayan Valley CHD GeneXpert Laboratory,2020-05-27,8,8,0,8,0,0,584,0,8,8,0,8,0.0,1.0,
Cagayan Valley CHD GeneXpert Laboratory,2020-05-28,44,44,0,44,0,0,540,0,52,52,0,52,0.0,1.0,
Cagayan Valley CHD GeneXpert Laboratory,2020-05-29,49,49,0,49,0,0,491,0,101,101,0,101,0.0,1.0,
Cagayan Valley CHD GeneXpert Laboratory,2020-05-30,52,52,0,52,0,0,439,0,153,153,0,153,0.0,1.0,
Cagayan Valley CHD GeneXpert Laboratory,2020-05-31,38,38,0,38,0,0,1237,0,191,191,0,191,0.0,1.0,
Cagayan Valley CHD GeneXpert Laboratory,2020-06-01,60,60,0,60,0,0,1176,0,251,251,0,251,0.0,1.0,
Cagayan Valley CHD GeneXpert Laboratory,2020-06-02,33,33,0,33,0,0,1143,0,284,284,0,284,0.0,1.0,
Cagayan Valley CHD GeneXpert Laboratory,2020-06-03,52,52,0,52,0,0,1091,0,336,336,0,336,0.0,1.0,
Cagayan Valley CHD GeneXpert Laboratory,2020-06-04,48,48,0,48,0,0,1043,0,384,384,0,384,0.0,1.0,
Cagayan Valley CHD GeneXpert Laboratory,2020-06-05,64,64,0,64,0,0,979,0,448,448,0,448,0.0,1.0,
Cagayan Valley CHD GeneXpert Laboratory,2020-06-06,54,54,0,54,0,0,923,0,502,502,0,502,0.0,1.0,
Cagayan Valley CHD GeneXpert Laboratory,2020-06-07,58,58,0,58,0,0,863,0,560,560,0,560,0.0,1.0,
Cagayan Valley CHD GeneXpert Laboratory,2020-06-08,24,24,0,24,0,0,838,0,584,584,0,584,0.0,1.0,
Cagayan Valley CHD GeneXpert Laboratory,2020-06-09,69,69,1,68,0,0,769,0,653,653,1,652,0.0,1.0,
Cagayan Valley CHD GeneXpert Laboratory,2020-06-10,43,43,2,41,0,0,3065,0,696,696,3,693,0.0,1.0,
Cagayan Valley CHD GeneXpert Laboratory,2020-06-11,57,56,0,56,0,0,0,0,753,752,3,749,0.0,1.0,
Cagayan Valley CHD GeneXpert Laboratory,2020-06-12,101,101,1,100,0,0,2903,0,854,853,4,849,0.0,1.0,
Cagayan Valley CHD GeneXpert Laboratory,2020-06-13,72,72,0,72,0,0,2829,0,926,925,4,921,0.0,1.0,
Cagayan Valley CHD GeneXpert Laboratory,2020-06-14,44,44,0,44,1,0,2784,0,970,969,4,965,0.0,1.0,
Cagayan Valley CHD GeneXpert Laboratory,2020-06-15,88,87,2,85,0,0,2696,0,1058,1056,6,1050,0.01,0.99,
Cagayan Valley CHD GeneXpert Laboratory,2020-06-16,104,104,2,102,0,0,2592,0,1162,1160,8,1152,0.01,0.99,
Cagayan Valley CHD GeneXpert Laboratory,2020-06-17,94,94,1,93,0,0,2496,0,1256,1254,9,1245,0.01,0.99,
Cagayan Valley CHD GeneXpert Laboratory,2020-06-18,103,102,1,101,0,0,2391,0,1359,1356,10,1346,0.01,0.99,
Cagayan Valley CHD GeneXpert Laboratory,2020-06-19,96,95,2,93,0,0,2295,0,1455,1451,12,1439,0.01,0.99,
Cagayan Valley CHD GeneXpert Laboratory,2020-06-20,104,103,1,102,0,0,2190,0,1559,1554,13,1541,0.01,0.99,
Cagayan Valley CHD GeneXpert Laboratory,2020-06-21,88,88,0,88,0,0,2102,0,1647,1642,13,1629,0.01,0.99,
Cagayan Valley CHD GeneXpert Laboratory,2020-06-22,103,103,4,99,0,0,1998,73,1750,1745,17,1728,0.01,0.99,
Cagayan Valley CHD GeneXpert Laboratory,2020-06-23,95,94,3,91,0,0,1902,83,1845,1839,20,1819,0.01,0.99,
Cagayan Valley CHD GeneXpert Laboratory,2020-06-24,95,91,2,89,1,0,1804,69,1940,1930,22,1908,0.01,0.99,
Cagayan Valley CHD GeneXpert Laboratory,2020-06-25,80,78,4,74,0,0,1724,70,2020,2008,26,1982,0.01,0.99,
Cagayan Valley CHD GeneXpert Laboratory,2020-06-26,228,226,7,219,0,0,1493,55,2248,2234,33,2201,0.01,0.99,
Cagayan Valley CHD GeneXpert Laboratory,2020-06-27,208,208,6,202,0,0,1284,154,2456,2442,39,2403,0.02,0.98,
Cebu TB Reference Laboratory - Molecular Facility for COVID-19 Testing,2020-05-07,44,44,3,41,,,9856,,44,44,3,41,0.07,0.93,
Cebu TB Reference Laboratory - Molecular Facility for COVID-19 Testing,2020-05-08,41,41,0,41,,,9815,,85,85,3,82,0.04,0.96,
Cebu TB Reference Laboratory - Molecular Facility for COVID-19 Testing,2020-05-09,0,0,0,0,,,9815,,85,85,3,82,0.04,0.96,
Cebu TB Reference Laboratory - Molecular Facility for COVID-19 Testing,2020-05-10,0,0,0,0,,,9815,,85,85,3,82,0.04,0.96,
Cebu TB Reference Laboratory - Molecular Facility for COVID-19 Testing,2020-05-11,40,40,0,40,,,9775,,125,125,3,122,0.02,0.98,
Cebu TB Reference Laboratory - Molecular Facility for COVID-19 Testing,2020-05-12,42,40,8,32,,,9733,,167,165,11,154,0.07,0.93,
Cebu TB Reference Laboratory - Molecular Facility for COVID-19 Testing,2020-05-13,72,72,4,68,,,9661,,239,237,15,222,0.06,0.94,
Cebu TB Reference Laboratory - Molecular Facility for COVID-19 Testing,2020-05-14,103,103,4,99,,,9558,,342,340,19,321,0.06,0.94,
Cebu TB Reference Laboratory - Molecular Facility for COVID-19 Testing,2020-05-15,148,148,31,117,,,9513,,490,488,50,438,0.1,0.9,
Cebu TB Reference Laboratory - Molecular Facility for COVID-19 Testing,2020-05-16,125,98,13,85,0,0,9536,,615,586,63,523,0.11,0.89,
Cebu TB Reference Laboratory - Molecular Facility for COVID-19 Testing,2020-05-17,173,173,1,172,0,0,9326,,788,759,64,695,0.08,0.92,
Cebu TB Reference Laboratory - Molecular Facility for COVID-19 Testing,2020-05-18,115,115,11,104,0,0,9211,,903,874,75,799,0.09,0.91,
Cebu TB Reference Laboratory - Molecular Facility for COVID-19 Testing,2020-05-19,164,164,38,126,0,0,9047,300,1067,1038,113,925,0.11,0.89,
Cebu TB Reference Laboratory - Molecular Facility for COVID-19 Testing,2020-05-20,260,260,23,237,0,0,8787,0,1327,1298,136,1162,0.1,0.9,
Cebu TB Reference Laboratory - Molecular Facility for COVID-19 Testing,2020-05-21,327,327,15,312,0,0,8460,500,1654,1625,151,1474,0.09,0.91,
Cebu TB Reference Laboratory - Molecular Facility for COVID-19 Testing,2020-05-22,307,307,7,300,0,0,8153,300,1961,1932,158,1774,0.08,0.92,
Cebu TB Reference Laboratory - Molecular Facility for COVID-19 Testing,2020-05-23,256,256,51,205,0,0,7897,400,2217,2188,209,1979,0.1,0.9,
Cebu TB Reference Laboratory - Molecular Facility for COVID-19 Testing,2020-05-24,333,333,18,315,0,0,8250,300,2550,2521,227,2294,0.09,0.91,
Cebu TB Reference Laboratory - Molecular Facility for COVID-19 Testing,2020-05-25,126,126,35,91,0,0,7438,300,2676,2647,262,2385,0.1,0.9,
Cebu TB Reference Laboratory - Molecular Facility for COVID-19 Testing,2020-05-26,112,112,35,77,0,0,7326,50,2788,2759,297,2462,0.11,0.89,
Cebu TB Reference Laboratory - Molecular Facility for COVID-19 Testing,2020-05-27,129,129,20,109,0,0,7580,150,2917,2888,317,2571,0.11,0.89,
Cebu TB Reference Laboratory - Molecular Facility for COVID-19 Testing,2020-05-28,349,349,90,259,0,0,6848,50,3266,3237,407,2830,0.13,0.87,
Cebu TB Reference Laboratory - Molecular Facility for COVID-19 Testing,2020-05-29,598,598,45,553,0,0,6250,45,3864,3835,452,3383,0.12,0.88,
Cebu TB Reference Laboratory - Molecular Facility for COVID-19 Testing,2020-05-30,417,417,42,375,0,0,5833,45,4281,4252,494,3758,0.12,0.88,
Cebu TB Reference Laboratory - Molecular Facility for COVID-19 Testing,2020-05-31,278,278,26,252,0,0,5555,30,4559,4530,520,4010,0.11,0.89,
Cebu TB Reference Laboratory - Molecular Facility for COVID-19 Testing,2020-06-01,432,432,55,377,0,0,4933,0,4991,4962,575,4387,0.12,0.88,
Cebu TB Reference Laboratory - Molecular Facility for COVID-19 Testing,2020-06-02,539,539,65,474,0,0,4584,0,5530,5501,640,4861,0.12,0.88,
Cebu TB Reference Laboratory - Molecular Facility for COVID-19 Testing,2020-06-03,656,656,178,478,0,0,3928,0,6186,6157,818,5339,0.13,0.87,
Cebu TB Reference Laboratory - Molecular Facility for COVID-19 Testing,2020-06-04,601,601,135,466,0,0,3327,0,6787,6758,953,5805,0.14,0.86,
Cebu TB Reference Laboratory - Molecular Facility for COVID-19 Testing,2020-06-05,360,360,120,240,0,0,2500,0,7147,7118,1073,6045,0.15,0.85,
Cebu TB Reference Laboratory - Molecular Facility for COVID-19 Testing,2020-06-06,306,306,75,231,0,0,2100,0,7453,7424,1148,6276,0.15,0.85,
Cebu TB Reference Laboratory - Molecular Facility for COVID-19 Testing,2020-06-07,161,161,27,134,0,0,2300,0,7614,7585,1175,6410,0.15,0.85,
Cebu TB Reference Laboratory - Molecular Facility for COVID-19 Testing,2020-06-08,268,268,89,179,0,0,2001,0,7882,7853,1264,6589,0.16,0.84,
Cebu TB Reference Laboratory - Molecular Facility for COVID-19 Testing,2020-06-09,270,270,37,233,0,0,2100,0,8152,8123,1301,6822,0.16,0.84,
Cebu TB Reference Laboratory - Molecular Facility for COVID-19 Testing,2020-06-10,406,406,150,256,0,0,1556,0,8558,8529,1451,7078,0.17,0.83,
Cebu TB Reference Laboratory - Molecular Facility for COVID-19 Testing,2020-06-11,524,524,80,444,0,0,5032,0,9082,9053,1531,7522,0.17,0.83,
Cebu TB Reference Laboratory - Molecular Facility for COVID-19 Testing,2020-06-12,373,373,67,306,0,0,4890,0,9455,9426,1598,7828,0.17,0.83,
Cebu TB Reference Laboratory - Molecular Facility for COVID-19 Testing,2020-06-13,807,807,268,539,0,0,3209,0,10262,10233,1866,8367,0.18,0.82,
Cebu TB Reference Laboratory - Molecular Facility for COVID-19 Testing,2020-06-14,303,286,70,216,0,0,3800,0,10565,10519,1936,8583,0.18,0.82,
Cebu TB Reference Laboratory - Molecular Facility for COVID-19 Testing,2020-06-15,681,644,187,457,0,0,2848,0,11246,11163,2123,9040,0.19,0.81,
Cebu TB Reference Laboratory - Molecular Facility for COVID-19 Testing,2020-06-16,319,301,40,261,0,0,2529,0,11565,11464,2163,9301,0.19,0.81,
Cebu TB Reference Laboratory - Molecular Facility for COVID-19 Testing,2020-06-17,243,223,75,148,0,0,2286,0,11808,11687,2238,9449,0.19,0.81,
Cebu TB Reference Laboratory - Molecular Facility for COVID-19 Testing,2020-06-18,285,259,72,187,0,0,2001,0,12093,11946,2310,9636,0.19,0.81,
Cebu TB Reference Laboratory - Molecular Facility for COVID-19 Testing,2020-06-19,302,274,53,221,0,0,2690,0,12395,12220,2363,9857,0.19,0.81,
Cebu TB Reference Laboratory - Molecular Facility for COVID-19 Testing,2020-06-20,240,227,32,195,0,0,1301,0,12635,12447,2395,10052,0.19,0.81,
Cebu TB Reference Laboratory - Molecular Facility for COVID-19 Testing,2020-06-21,231,231,38,193,0,0,1228,0,12866,12678,2433,10245,0.19,0.81,
Cebu TB Reference Laboratory - Molecular Facility for COVID-19 Testing,2020-06-22,283,263,95,168,0,0,4945,0,13149,12941,2528,10413,0.2,0.8,
Cebu TB Reference Laboratory - Molecular Facility for COVID-19 Testing,2020-06-23,71,71,13,58,0,0,4874,0,13220,13012,2541,10471,0.2,0.8,
Cebu TB Reference Laboratory - Molecular Facility for COVID-19 Testing,2020-06-24,242,242,31,211,0,0,4632,0,13462,13254,2572,10682,0.19,0.81,
Cebu TB Reference Laboratory - Molecular Facility for COVID-19 Testing,2020-06-25,511,487,90,397,0,0,0,0,13973,13741,2662,11079,0.19,0.81,
Cebu TB Reference Laboratory - Molecular Facility for COVID-19 Testing,2020-06-26,684,684,153,531,0,0,3413,0,14657,14425,2815,11610,0.2,0.8,
Cebu TB Reference Laboratory - Molecular Facility for COVID-19 Testing,2020-06-27,525,525,141,384,0,0,2310,0,15182,14950,2956,11994,0.2,0.8,
Chinese General Hospital,2020-04-17,49,49,3,46,,,1610,,49,49,3,46,0.06,0.94,
Chinese General Hospital,2020-04-18,58,55,3,52,,,1550,,107,104,6,98,0.06,0.94,
Chinese General Hospital,2020-04-19,26,26,1,25,,,1298,,133,130,7,123,0.05,0.95,
Chinese General Hospital,2020-04-20,159,159,17,142,,,1128,,292,289,24,265,0.08,0.92,
Chinese General Hospital,2020-04-21,62,62,10,52,,,1063,,354,351,34,317,0.1,0.9,
Chinese General Hospital,2020-04-22,134,134,20,114,,,918,,488,485,54,431,0.11,0.89,
Chinese General Hospital,2020-04-23,81,81,6,75,,,832,,569,566,60,506,0.11,0.89,
Chinese General Hospital,2020-04-24,108,107,26,81,,,722,,677,673,86,587,0.13,0.87,
Chinese General Hospital,2020-04-25,59,58,0,58,,,722,,736,731,86,645,0.12,0.88,
Chinese General Hospital,2020-04-26,0,0,0,0,,,722,,736,731,86,645,0.12,0.88,
Chinese General Hospital,2020-04-27,88,88,14,74,,,722,,824,819,100,719,0.12,0.88,
Chinese General Hospital,2020-04-28,196,196,38,158,,,722,,1020,1015,138,877,0.14,0.86,
Chinese General Hospital,2020-04-29,189,189,6,183,,,722,,1209,1204,144,1060,0.12,0.88,
Chinese General Hospital,2020-04-30,88,88,5,83,,,722,,1297,1292,149,1143,0.12,0.88,
Chinese General Hospital,2020-05-01,229,229,19,210,,,722,,1526,1521,168,1353,0.11,0.89,
Chinese General Hospital,2020-05-02,94,94,2,92,,,722,,1620,1615,170,1445,0.11,0.89,
Chinese General Hospital,2020-05-03,0,0,0,0,,,722,,1620,1615,170,1445,0.11,0.89,
Chinese General Hospital,2020-05-04,21,21,2,19,,,722,,1641,1636,172,1464,0.11,0.89,
Chinese General Hospital,2020-05-05,56,56,6,50,,,722,,1697,1692,178,1514,0.11,0.89,
Chinese General Hospital,2020-05-06,130,130,12,118,,,722,,1827,1822,190,1632,0.1,0.9,
Chinese General Hospital,2020-05-07,300,300,65,235,,,722,,2127,2122,255,1867,0.12,0.88,
Chinese General Hospital,2020-05-08,80,80,4,76,,,722,,2207,2202,259,1943,0.12,0.88,
Chinese General Hospital,2020-05-09,101,101,1,100,,,722,,2308,2303,260,2043,0.11,0.89,
Chinese General Hospital,2020-05-10,0,0,0,0,,,722,,2308,2303,260,2043,0.11,0.89,
Chinese General Hospital,2020-05-11,366,366,24,342,,,,,2674,2669,284,2385,0.11,0.89,
Chinese General Hospital,2020-05-12,439,439,22,417,,,,,3113,3108,306,2802,0.1,0.9,
Chinese General Hospital,2020-05-13,315,315,11,304,,,3380,,3428,3423,317,3106,0.09,0.91,
Chinese General Hospital,2020-05-14,227,227,28,199,,,3065,,3655,3650,345,3305,0.09,0.91,
Chinese General Hospital,2020-05-15,115,105,10,95,,,2950,,3770,3755,355,3400,0.09,0.91,
Chinese General Hospital,2020-05-16,327,327,23,304,0,0,2625,,4097,4082,378,3704,0.09,0.91,
Chinese General Hospital,2020-05-17,0,0,0,0,0,0,,,4097,4082,378,3704,0.09,0.91,
Chinese General Hospital,2020-05-18,483,483,94,389,0,0,2142,,4580,4565,472,4093,0.1,0.9,
Chinese General Hospital,2020-05-19,685,685,114,571,0,0,1457,150,5265,5250,586,4664,0.11,0.89,
Chinese General Hospital,2020-05-20,284,281,37,244,0,3,1176,0,5549,5531,623,4908,0.11,0.89,
Chinese General Hospital,2020-05-21,402,402,33,369,0,0,774,0,5951,5933,656,5277,0.11,0.89,
Chinese General Hospital,2020-05-22,702,702,83,619,0,0,72,0,6653,6635,739,5896,0.11,0.89,
Chinese General Hospital,2020-05-23,422,422,57,365,0,0,1496,0,7075,7057,796,6261,0.11,0.89,
Chinese General Hospital,2020-05-24,642,642,92,550,0,0,854,0,7717,7699,888,6811,0.12,0.88,
Chinese General Hospital,2020-05-25,663,662,72,590,1,0,1496,0,8380,8361,960,7401,0.11,0.89,
Chinese General Hospital,2020-05-26,183,183,25,158,0,0,1313,0,8563,8544,985,7559,0.12,0.88,
Chinese General Hospital,2020-05-27,247,247,65,182,0,0,1066,0,8810,8791,1050,7741,0.12,0.88,
Chinese General Hospital,2020-05-28,251,251,20,231,0,0,815,0,9061,9042,1070,7972,0.12,0.88,
Chinese General Hospital,2020-05-29,429,429,68,361,0,0,386,0,9490,9471,1138,8333,0.12,0.88,
Chinese General Hospital,2020-05-30,235,235,24,211,0,0,151,0,9725,9706,1162,8544,0.12,0.88,
Chinese General Hospital,2020-05-31,702,702,52,650,0,0,4315,0,10427,10408,1214,9194,0.12,0.88,
Chinese General Hospital,2020-06-01,298,298,39,259,0,0,4017,0,10725,10706,1253,9453,0.12,0.88,
Chinese General Hospital,2020-06-02,220,220,18,202,0,0,3797,0,10945,10926,1271,9655,0.12,0.88,
Chinese General Hospital,2020-06-03,242,242,21,221,0,0,3555,0,11187,11168,1292,9876,0.12,0.88,
Chinese General Hospital,2020-06-04,338,338,36,302,0,0,3217,0,11525,11506,1328,10178,0.12,0.88,
Chinese General Hospital,2020-06-05,357,357,73,284,0,0,2557,0,11882,11863,1401,10462,0.12,0.88,
Chinese General Hospital,2020-06-06,0,0,0,0,0,0,2557,0,11882,11863,1401,10462,0.12,0.88,
Chinese General Hospital,2020-06-07,,,,,,,,,11882,11863,1401,10462,0.12,0.88,
Chinese General Hospital,2020-06-08,857,857,172,685,0,0,1700,0,12739,12720,1573,11147,0.12,0.88,
Chinese General Hospital,2020-06-09,581,581,111,470,0,0,1119,0,13320,13301,1684,11617,0.13,0.87,
Chinese General Hospital,2020-06-10,320,320,29,291,0,0,799,0,13640,13621,1713,11908,0.13,0.87,
Chinese General Hospital,2020-06-11,314,314,112,202,0,0,485,0,13954,13935,1825,12110,0.13,0.87,
Chinese General Hospital,2020-06-12,,,,,,,,,13954,13935,1825,12110,0.13,0.87,
Chinese General Hospital,2020-06-13,340,340,29,311,0,0,690,0,14294,14275,1854,12421,0.13,0.87,
Chinese General Hospital,2020-06-14,,,,,,,,,14294,14275,1854,12421,0.13,0.87,
Chinese General Hospital,2020-06-15,872,871,90,781,1,0,800,0,15166,15146,1944,13202,0.13,0.87,
Chinese General Hospital,2020-06-16,574,574,89,485,0,0,600,0,15740,15720,2033,13687,0.13,0.87,
Chinese General Hospital,2020-06-17,439,439,61,378,0,0,700,0,16179,16159,2094,14065,0.13,0.87,
Chinese General Hospital,2020-06-18,698,698,75,623,0,0,700,0,16877,16857,2169,14688,0.13,0.87,
Chinese General Hospital,2020-06-19,478,476,54,422,0,0,1200,0,17355,17333,2223,15110,0.13,0.87,
Chinese General Hospital,2020-06-20,791,791,67,724,0,0,900,0,18146,18124,2290,15834,0.13,0.87,
Chinese General Hospital,2020-06-21,0,0,0,0,0,0,1600,0,18146,18124,2290,15834,0.13,0.87,
Chinese General Hospital,2020-06-22,1299,1299,130,1169,0,0,1200,0,19445,19423,2420,17003,0.12,0.88,
Chinese General Hospital,2020-06-23,357,357,135,222,0,0,900,0,19802,19780,2555,17225,0.13,0.87,
Chinese General Hospital,2020-06-24,511,510,74,436,1,0,900,0,20313,20290,2629,17661,0.13,0.87,
Chinese General Hospital,2020-06-25,654,654,96,558,0,0,750,0,20967,20944,2725,18219,0.13,0.87,
Chinese General Hospital,2020-06-26,528,528,103,425,0,0,402,0,21495,21472,2828,18644,0.13,0.87,
Chinese General Hospital,2020-06-27,744,744,99,645,0,0,900,0,22239,22216,2927,19289,0.13,0.87,
Cotabato Regional and Medical Center GeneXpert Laboratory,2020-05-21,13,13,1,12,0,0,1127,0,13,13,1,12,0.08,0.92,
Cotabato Regional and Medical Center GeneXpert Laboratory,2020-05-22,23,23,1,22,0,0,1104,5,36,36,2,34,0.06,0.94,
Cotabato Regional and Medical Center GeneXpert Laboratory,2020-05-23,36,35,0,35,0,0,1068,0,72,71,2,69,0.03,0.97,
Cotabato Regional and Medical Center GeneXpert Laboratory,2020-05-24,42,42,0,42,0,0,1026,39,114,113,2,111,0.02,0.98,
Cotabato Regional and Medical Center GeneXpert Laboratory,2020-05-25,56,56,11,45,0,0,969,21,170,169,13,156,0.08,0.92,
Cotabato Regional and Medical Center GeneXpert Laboratory,2020-05-26,12,7,0,7,0,5,957,0,182,176,13,163,0.07,0.93,
Cotabato Regional and Medical Center GeneXpert Laboratory,2020-05-27,49,48,0,48,0,0,908,0,231,224,13,211,0.06,0.94,
Cotabato Regional and Medical Center GeneXpert Laboratory,2020-05-28,31,31,1,30,0,0,877,0,262,255,14,241,0.05,0.95,
Cotabato Regional and Medical Center GeneXpert Laboratory,2020-05-29,20,18,0,18,0,0,857,0,282,273,14,259,0.05,0.95,
Cotabato Regional and Medical Center GeneXpert Laboratory,2020-05-30,49,49,3,46,0,0,808,0,331,322,17,305,0.05,0.95,
Cotabato Regional and Medical Center GeneXpert Laboratory,2020-05-31,24,24,0,24,0,0,1744,0,355,346,17,329,0.05,0.95,
Cotabato Regional and Medical Center GeneXpert Laboratory,2020-06-01,9,8,0,8,0,0,1734,0,364,354,17,337,0.05,0.95,
Cotabato Regional and Medical Center GeneXpert Laboratory,2020-06-02,33,32,3,29,0,0,1641,0,397,386,20,366,0.05,0.95,
Cotabato Regional and Medical Center GeneXpert Laboratory,2020-06-03,6,5,0,5,0,0,1635,0,403,391,20,371,0.05,0.95,
Cotabato Regional and Medical Center GeneXpert Laboratory,2020-06-04,19,18,1,17,0,0,1616,0,422,409,21,388,0.05,0.95,
Cotabato Regional and Medical Center GeneXpert Laboratory,2020-06-05,39,39,1,38,0,0,1577,0,461,448,22,426,0.05,0.95,
Cotabato Regional and Medical Center GeneXpert Laboratory,2020-06-06,34,33,0,33,0,0,1543,0,495,481,22,459,0.05,0.95,
Cotabato Regional and Medical Center GeneXpert Laboratory,2020-06-07,1,1,1,0,0,0,1542,0,496,482,23,459,0.05,0.95,
Cotabato Regional and Medical Center GeneXpert Laboratory,2020-06-08,3,3,2,1,0,0,1539,0,499,485,25,460,0.05,0.95,
Cotabato Regional and Medical Center GeneXpert Laboratory,2020-06-09,16,16,0,16,0,0,1523,0,515,501,25,476,0.05,0.95,
Cotabato Regional and Medical Center GeneXpert Laboratory,2020-06-10,31,24,1,23,0,0,1492,0,546,525,26,499,0.05,0.95,
Cotabato Regional and Medical Center GeneXpert Laboratory,2020-06-11,40,35,0,35,0,0,1452,0,586,560,26,534,0.05,0.95,
Cotabato Regional and Medical Center GeneXpert Laboratory,2020-06-12,46,46,1,45,0,0,1406,0,632,606,27,579,0.04,0.96,
Cotabato Regional and Medical Center GeneXpert Laboratory,2020-06-13,10,7,0,7,0,0,1396,0,642,613,27,586,0.04,0.96,
Cotabato Regional and Medical Center GeneXpert Laboratory,2020-06-14,16,16,0,16,0,0,1374,0,658,629,27,602,0.04,0.96,
Cotabato Regional and Medical Center GeneXpert Laboratory,2020-06-15,14,14,1,13,0,0,1360,0,672,643,28,615,0.04,0.96,
Cotabato Regional and Medical Center GeneXpert Laboratory,2020-06-16,89,88,6,82,0,0,1270,0,761,731,34,697,0.05,0.95,
Cotabato Regional and Medical Center GeneXpert Laboratory,2020-06-17,24,21,0,21,0,0,1246,0,785,752,34,718,0.05,0.95,
Cotabato Regional and Medical Center GeneXpert Laboratory,2020-06-18,53,52,0,52,0,0,1193,0,838,804,34,770,0.04,0.96,
Cotabato Regional and Medical Center GeneXpert Laboratory,2020-06-19,44,36,1,35,0,0,1149,0,882,840,35,805,0.04,0.96,
Cotabato Regional and Medical Center GeneXpert Laboratory,2020-06-20,39,39,4,35,0,0,1110,0,921,879,39,840,0.04,0.96,
Cotabato Regional and Medical Center GeneXpert Laboratory,2020-06-21,38,38,12,26,0,0,1071,0,959,917,51,866,0.06,0.94,
Cotabato Regional and Medical Center GeneXpert Laboratory,2020-06-22,11,11,0,11,0,0,1060,0,970,928,51,877,0.05,0.95,
Cotabato Regional and Medical Center GeneXpert Laboratory,2020-06-23,61,60,4,56,0,0,986,0,1031,988,55,933,0.06,0.94,
Cotabato Regional and Medical Center GeneXpert Laboratory,2020-06-24,35,30,1,29,0,0,949,0,1066,1018,56,962,0.06,0.94,
Cotabato Regional and Medical Center GeneXpert Laboratory,2020-06-25,34,33,5,28,0,0,915,0,1100,1051,61,990,0.06,0.94,
Cotabato Regional and Medical Center GeneXpert Laboratory,2020-06-26,54,53,2,51,0,0,861,0,1154,1104,63,1041,0.06,0.94,
Cotabato Regional and Medical Center GeneXpert Laboratory,2020-06-27,75,63,4,59,0,0,786,0,1229,1167,67,1100,0.06,0.94,
Davao One World Diagnostic Center Incorporated,2020-06-01,12,12,0,12,0,0,7920,0,12,12,0,12,0.0,1.0,
Davao One World Diagnostic Center Incorporated,2020-06-02,71,53,0,53,0,18,7800,0,83,65,0,65,0.0,1.0,
Davao One World Diagnostic Center Incorporated,2020-06-03,18,18,0,18,0,0,7656,0,101,83,0,83,0.0,1.0,
Davao One World Diagnostic Center Incorporated,2020-06-04,115,115,0,115,0,0,7632,0,216,198,0,198,0.0,1.0,
Davao One World Diagnostic Center Incorporated,2020-06-05,75,75,0,75,0,0,7536,0,291,273,0,273,0.0,1.0,
Davao One World Diagnostic Center Incorporated,2020-06-06,78,78,0,78,0,0,7379,0,369,351,0,351,0.0,1.0,
Davao One World Diagnostic Center Incorporated,2020-06-07,7,7,0,7,0,0,7368,0,376,358,0,358,0.0,1.0,
Davao One World Diagnostic Center Incorporated,2020-06-08,0,0,0,0,0,0,7368,0,376,358,0,358,0.0,1.0,
Davao One World Diagnostic Center Incorporated,2020-06-09,3,3,0,3,0,0,7361,0,379,361,0,361,0.0,1.0,
Davao One World Diagnostic Center Incorporated,2020-06-10,20,20,0,20,0,0,7320,0,399,381,0,381,0.0,1.0,
Davao One World Diagnostic Center Incorporated,2020-06-11,,,,,,,,,399,381,0,381,0.0,1.0,
Davao One World Diagnostic Center Incorporated,2020-06-12,5,5,0,5,0,0,7296,0,404,386,0,386,0.0,1.0,
Davao One World Diagnostic Center Incorporated,2020-06-13,0,0,0,0,0,0,7296,0,404,386,0,386,0.0,1.0,
Davao One World Diagnostic Center Incorporated,2020-06-14,13,13,0,13,0,0,7279,0,417,399,0,399,0.0,1.0,
Davao One World Diagnostic Center Incorporated,2020-06-15,10,10,0,10,0,0,8784,0,427,409,0,409,0.0,1.0,
Davao One World Diagnostic Center Incorporated,2020-06-16,4,4,0,4,0,0,8776,0,431,413,0,413,0.0,1.0,
Davao One World Diagnostic Center Incorporated,2020-06-17,15,15,0,15,0,0,8757,0,446,428,0,428,0.0,1.0,
Davao One World Diagnostic Center Incorporated,2020-06-18,16,16,0,16,0,0,8737,0,462,444,0,444,0.0,1.0,
Davao One World Diagnostic Center Incorporated,2020-06-19,,,,,,,,,462,444,0,444,0.0,1.0,
Davao One World Diagnostic Center Incorporated,2020-06-20,12,12,0,12,0,0,8721,0,474,456,0,456,0.0,1.0,
Davao One World Diagnostic Center Incorporated,2020-06-21,13,13,0,13,0,0,8704,0,487,469,0,469,0.0,1.0,
Davao One World Diagnostic Center Incorporated,2020-06-22,0,0,0,0,0,0,8704,0,487,469,0,469,0.0,1.0,
Davao One World Diagnostic Center Incorporated,2020-06-23,22,22,0,22,0,0,8678,0,509,491,0,491,0.0,1.0,
Davao One World Diagnostic Center Incorporated,2020-06-24,19,19,0,19,0,0,8616,0,528,510,0,510,0.0,1.0,
Davao One World Diagnostic Center Incorporated,2020-06-25,13,13,0,13,0,0,8599,0,541,523,0,523,0.0,1.0,
Davao One World Diagnostic Center Incorporated,2020-06-26,48,48,1,47,0,0,8547,0,589,571,1,570,0.0,1.0,
Davao One World Diagnostic Center Incorporated,2020-06-27,28,28,1,27,0,0,8515,0,617,599,2,597,0.0,1.0,
Davao Regional Medical Center GeneXpert Laboratory,2020-05-30,34,34,0,34,0,2,1104,4,34,34,0,34,0.0,1.0,
Davao Regional Medical Center GeneXpert Laboratory,2020-05-31,15,15,0,15,0,5,1144,0,49,49,0,49,0.0,1.0,
Davao Regional Medical Center GeneXpert Laboratory,2020-06-01,32,32,0,32,0,0,1112,0,81,81,0,81,0.0,1.0,
Davao Regional Medical Center GeneXpert Laboratory,2020-06-02,28,28,0,28,0,0,1084,0,109,109,0,109,0.0,1.0,
Davao Regional Medical Center GeneXpert Laboratory,2020-06-03,30,28,0,28,0,2,1054,0,139,137,0,137,0.0,1.0,
Davao Regional Medical Center GeneXpert Laboratory,2020-06-04,12,12,0,12,0,0,1042,0,151,149,0,149,0.0,1.0,
Davao Regional Medical Center GeneXpert Laboratory,2020-06-05,19,19,1,18,0,0,1024,0,170,168,1,167,0.01,0.99,
Davao Regional Medical Center GeneXpert Laboratory,2020-06-06,0,0,0,0,0,0,1024,0,170,168,1,167,0.01,0.99,
Davao Regional Medical Center GeneXpert Laboratory,2020-06-07,0,0,0,0,0,0,1024,0,170,168,1,167,0.01,0.99,
Davao Regional Medical Center GeneXpert Laboratory,2020-06-08,28,28,0,28,0,0,995,0,198,196,1,195,0.01,0.99,
Davao Regional Medical Center GeneXpert Laboratory,2020-06-09,49,49,0,49,0,0,946,0,247,245,1,244,0.0,1.0,
Davao Regional Medical Center GeneXpert Laboratory,2020-06-10,20,20,0,20,0,0,926,0,267,265,1,264,0.0,1.0,
Davao Regional Medical Center GeneXpert Laboratory,2020-06-11,56,56,0,56,0,0,869,0,323,321,1,320,0.0,1.0,
Davao Regional Medical Center GeneXpert Laboratory,2020-06-12,53,49,0,49,0,1,816,0,376,370,1,369,0.0,1.0,
Davao Regional Medical Center GeneXpert Laboratory,2020-06-13,0,0,0,0,0,0,816,0,376,370,1,369,0.0,1.0,
Davao Regional Medical Center GeneXpert Laboratory,2020-06-14,0,0,0,0,0,0,816,0,376,370,1,369,0.0,1.0,
Davao Regional Medical Center GeneXpert Laboratory,2020-06-15,40,38,0,38,0,0,776,0,416,408,1,407,0.0,1.0,
Davao Regional Medical Center GeneXpert Laboratory,2020-06-16,51,48,0,48,0,3,725,0,467,456,1,455,0.0,1.0,
Davao Regional Medical Center GeneXpert Laboratory,2020-06-17,60,55,0,55,0,5,665,24,527,511,1,510,0.0,1.0,
Davao Regional Medical Center GeneXpert Laboratory,2020-06-18,57,56,0,56,0,1,608,60,584,567,1,566,0.0,1.0,
Davao Regional Medical Center GeneXpert Laboratory,2020-06-19,92,91,0,91,0,1,516,35,676,658,1,657,0.0,1.0,
Davao Regional Medical Center GeneXpert Laboratory,2020-06-20,0,0,0,0,0,0,516,18,676,658,1,657,0.0,1.0,
Davao Regional Medical Center GeneXpert Laboratory,2020-06-21,0,0,0,0,0,0,516,18,676,658,1,657,0.0,1.0,
Davao Regional Medical Center GeneXpert Laboratory,2020-06-22,69,64,4,60,0,0,447,18,745,722,5,717,0.01,0.99,
Davao Regional Medical Center GeneXpert Laboratory,2020-06-23,56,55,1,54,0,1,391,0,801,777,6,771,0.01,0.99,
Davao Regional Medical Center GeneXpert Laboratory,2020-06-24,56,56,5,51,0,0,334,0,857,833,11,822,0.01,0.99,
Davao Regional Medical Center GeneXpert Laboratory,2020-06-25,92,91,2,89,0,0,242,0,949,924,13,911,0.01,0.99,
Davao Regional Medical Center GeneXpert Laboratory,2020-06-26,55,55,2,53,0,0,187,0,1004,979,15,964,0.02,0.98,
Davao Regional Medical Center GeneXpert Laboratory,2020-06-27,5,5,0,5,0,0,1082,0,1009,984,15,969,0.02,0.98,
De La Salle Medical and Health Sciences Institute,2020-05-11,58,55,0,55,,,456,,58,55,0,55,0.0,1.0,
De La Salle Medical and Health Sciences Institute,2020-05-12,121,121,0,121,,,384,,179,176,0,176,0.0,1.0,
De La Salle Medical and Health Sciences Institute,2020-05-13,146,146,6,140,,,312,,325,322,6,316,0.02,0.98,
De La Salle Medical and Health Sciences Institute,2020-05-14,122,122,4,118,,,9709,,447,444,10,434,0.02,0.98,
De La Salle Medical and Health Sciences Institute,2020-05-15,120,120,2,118,,,9595,,567,564,12,552,0.02,0.98,
De La Salle Medical and Health Sciences Institute,2020-05-16,122,122,1,121,0,0,9481,,689,686,13,673,0.02,0.98,
De La Salle Medical and Health Sciences Institute,2020-05-17,61,61,0,61,0,0,9424,,750,747,13,734,0.02,0.98,
De La Salle Medical and Health Sciences Institute,2020-05-18,60,60,0,60,0,0,9310,,810,807,13,794,0.02,0.98,
De La Salle Medical and Health Sciences Institute,2020-05-19,120,120,0,120,0,0,9044,1166,930,927,13,914,0.01,0.99,
De La Salle Medical and Health Sciences Institute,2020-05-20,122,122,7,115,0,0,8968,1084,1052,1049,20,1029,0.02,0.98,
De La Salle Medical and Health Sciences Institute,2020-05-21,120,120,1,119,0,0,8854,938,1172,1169,21,1148,0.02,0.98,
De La Salle Medical and Health Sciences Institute,2020-05-22,122,122,0,122,0,0,8854,829,1294,1291,21,1270,0.02,0.98,
De La Salle Medical and Health Sciences Institute,2020-05-23,120,120,1,119,0,0,8740,709,1414,1411,22,1389,0.02,0.98,
De La Salle Medical and Health Sciences Institute,2020-05-24,62,62,4,58,0,0,8683,647,1476,1473,26,1447,0.02,0.98,
De La Salle Medical and Health Sciences Institute,2020-05-25,60,60,0,60,0,0,8512,585,1536,1533,26,1507,0.02,0.98,
De La Salle Medical and Health Sciences Institute,2020-05-26,122,122,0,122,0,0,8398,486,1658,1655,26,1629,0.02,0.98,
De La Salle Medical and Health Sciences Institute,2020-05-27,170,170,2,168,0,0,7923,325,1828,1825,28,1797,0.02,0.98,
De La Salle Medical and Health Sciences Institute,2020-05-28,195,194,0,194,0,1,7714,0,2023,2019,28,1991,0.01,0.99,
De La Salle Medical and Health Sciences Institute,2020-05-29,60,60,0,60,0,0,7657,0,2083,2079,28,2051,0.01,0.99,
De La Salle Medical and Health Sciences Institute,2020-05-30,103,103,1,102,0,0,7543,0,2186,2182,29,2153,0.01,0.99,
De La Salle Medical and Health Sciences Institute,2020-05-31,43,43,0,43,0,0,7486,0,2229,2225,29,2196,0.01,0.99,
De La Salle Medical and Health Sciences Institute,2020-06-01,0,0,0,0,0,0,12521,0,2229,2225,29,2196,0.01,0.99,
De La Salle Medical and Health Sciences Institute,2020-06-02,38,37,0,37,0,1,12464,0,2267,2262,29,2233,0.01,0.99,
De La Salle Medical and Health Sciences Institute,2020-06-03,134,133,1,132,0,1,12350,10,2401,2395,30,2365,0.01,0.99,
De La Salle Medical and Health Sciences Institute,2020-06-04,71,71,3,68,0,0,12274,73,2472,2466,33,2433,0.01,0.99,
De La Salle Medical and Health Sciences Institute,2020-06-05,126,124,0,124,0,2,12046,72,2598,2590,33,2557,0.01,0.99,
De La Salle Medical and Health Sciences Institute,2020-06-06,183,183,2,181,0,0,11818,251,2781,2773,35,2738,0.01,0.99,
De La Salle Medical and Health Sciences Institute,2020-06-07,119,119,1,118,0,0,11704,224,2900,2892,36,2856,0.01,0.99,
De La Salle Medical and Health Sciences Institute,2020-06-08,96,96,1,95,0,0,11742,180,2996,2988,37,2951,0.01,0.99,
De La Salle Medical and Health Sciences Institute,2020-06-09,216,216,0,216,0,0,11419,154,3212,3204,37,3167,0.01,0.99,
De La Salle Medical and Health Sciences Institute,2020-06-10,119,119,0,119,0,0,11324,270,3331,3323,37,3286,0.01,0.99,
De La Salle Medical and Health Sciences Institute,2020-06-11,198,198,3,195,0,0,11267,274,3529,3521,40,3481,0.01,0.99,
De La Salle Medical and Health Sciences Institute,2020-06-12,236,236,0,236,0,0,11153,495,3765,3757,40,3717,0.01,0.99,
De La Salle Medical and Health Sciences Institute,2020-06-13,120,120,0,120,0,0,11053,375,3885,3877,40,3837,0.01,0.99,
De La Salle Medical and Health Sciences Institute,2020-06-14,0,0,0,0,0,0,11053,375,3885,3877,40,3837,0.01,0.99,
De La Salle Medical and Health Sciences Institute,2020-06-15,92,91,3,88,0,1,11077,607,3977,3968,43,3925,0.01,0.99,
De La Salle Medical and Health Sciences Institute,2020-06-16,173,173,0,173,0,0,10374,292,4150,4141,43,4098,0.01,0.99,
De La Salle Medical and Health Sciences Institute,2020-06-17,204,203,9,194,0,1,10127,616,4354,4344,52,4292,0.01,0.99,
De La Salle Medical and Health Sciences Institute,2020-06-18,204,203,9,194,0,1,10127,616,4558,4547,61,4486,0.01,0.99,
De La Salle Medical and Health Sciences Institute,2020-06-19,239,239,0,239,0,0,9899,425,4797,4786,61,4725,0.01,0.99,
De La Salle Medical and Health Sciences Institute,2020-06-20,240,239,2,237,0,1,9557,397,5037,5025,63,4962,0.01,0.99,
De La Salle Medical and Health Sciences Institute,2020-06-21,239,239,3,236,0,0,9443,277,5276,5264,66,5198,0.01,0.99,
De La Salle Medical and Health Sciences Institute,2020-06-22,60,60,0,60,0,0,9272,371,5336,5324,66,5258,0.01,0.99,
De La Salle Medical and Health Sciences Institute,2020-06-23,240,240,28,212,0,0,9443,277,5576,5564,94,5470,0.02,0.98,
De La Salle Medical and Health Sciences Institute,2020-06-24,172,170,7,163,0,2,8873,0,5748,5734,101,5633,0.02,0.98,
De La Salle Medical and Health Sciences Institute,2020-06-25,224,224,15,209,0,0,8721,0,5972,5958,116,5842,0.02,0.98,
De La Salle Medical and Health Sciences Institute,2020-06-26,200,200,4,196,0,0,8493,0,6172,6158,120,6038,0.02,0.98,
De La Salle Medical and Health Sciences Institute,2020-06-27,236,235,9,226,0,1,7830,193,6408,6393,129,6264,0.02,0.98,
Detoxicare Molecular Diagnostics Laboratory,2020-05-14,283,283,17,266,,,224,,6062,6062,346,5716,0.06,0.94,
Detoxicare Molecular Diagnostics Laboratory,2020-05-15,479,479,14,465,,,,,6541,6541,360,6181,0.06,0.94,
Detoxicare Molecular Diagnostics Laboratory,2020-05-16,805,803,20,783,0,0,,,7346,7344,380,6964,0.05,0.95,
Detoxicare Molecular Diagnostics Laboratory,2020-05-17,445,443,49,394,0,0,,,7791,7787,429,7358,0.06,0.94,
Detoxicare Molecular Diagnostics Laboratory,2020-05-18,33,33,1,32,0,0,0,,7824,7820,430,7390,0.05,0.95,
Detoxicare Molecular Diagnostics Laboratory,2020-05-19,468,448,25,423,0,1,1,0,8292,8268,455,7813,0.06,0.94,
Detoxicare Molecular Diagnostics Laboratory,2020-05-20,395,394,22,372,0,1,1,0,8687,8662,477,8185,0.06,0.94,
Detoxicare Molecular Diagnostics Laboratory,2020-05-21,702,702,35,667,0,0,1,0,9389,9364,512,8852,0.05,0.95,
Detoxicare Molecular Diagnostics Laboratory,2020-05-22,750,750,27,723,0,0,1,0,10139,10114,539,9575,0.05,0.95,
Detoxicare Molecular Diagnostics Laboratory,2020-05-23,995,990,58,932,0,5,0,0,11134,11104,597,10507,0.05,0.95,
Detoxicare Molecular Diagnostics Laboratory,2020-05-24,533,533,28,505,0,0,1,0,11667,11637,625,11012,0.05,0.95,
Detoxicare Molecular Diagnostics Laboratory,2020-05-25,162,162,23,139,0,0,0,0,11829,11799,648,11151,0.05,0.95,
Detoxicare Molecular Diagnostics Laboratory,2020-05-26,609,609,67,542,0,0,0,0,12438,12408,715,11693,0.06,0.94,
Detoxicare Molecular Diagnostics Laboratory,2020-05-27,750,750,34,716,0,0,0,0,13188,13158,749,12409,0.06,0.94,
Detoxicare Molecular Diagnostics Laboratory,2020-05-28,898,897,44,853,0,1,0,0,14086,14055,793,13262,0.06,0.94,
Detoxicare Molecular Diagnostics Laboratory,2020-05-29,829,829,24,805,0,0,688,3,14915,14884,817,14067,0.05,0.95,
Detoxicare Molecular Diagnostics Laboratory,2020-05-30,1255,1254,39,1215,0,1,1433,0,16170,16138,856,15282,0.05,0.95,
Detoxicare Molecular Diagnostics Laboratory,2020-05-31,797,797,28,769,0,0,636,318,16967,16935,884,16051,0.05,0.95,
Detoxicare Molecular Diagnostics Laboratory,2020-06-01,594,594,23,571,0,0,1958,102,17561,17529,907,16622,0.05,0.95,
Detoxicare Molecular Diagnostics Laboratory,2020-06-02,1080,1080,33,1047,0,0,878,7,18641,18609,940,17669,0.05,0.95,
Detoxicare Molecular Diagnostics Laboratory,2020-06-03,654,654,19,635,0,0,224,8,19295,19263,959,18304,0.05,0.95,
Detoxicare Molecular Diagnostics Laboratory,2020-06-04,535,535,57,478,0,0,1689,7,19830,19798,1016,18782,0.05,0.95,
Detoxicare Molecular Diagnostics Laboratory,2020-06-05,769,767,50,717,0,2,920,894,20599,20565,1066,19499,0.05,0.95,
Detoxicare Molecular Diagnostics Laboratory,2020-06-06,1422,1421,57,1364,0,1,1498,70,22021,21986,1123,20863,0.05,0.95,
Detoxicare Molecular Diagnostics Laboratory,2020-06-07,1198,1198,44,1154,0,0,2300,730,23219,23184,1167,22017,0.05,0.95,
Detoxicare Molecular Diagnostics Laboratory,2020-06-08,808,808,33,775,0,0,1492,474,24027,23992,1200,22792,0.05,0.95,
Detoxicare Molecular Diagnostics Laboratory,2020-06-09,1341,1341,68,1273,0,0,2151,16,25368,25333,1268,24065,0.05,0.95,
Detoxicare Molecular Diagnostics Laboratory,2020-06-10,1115,1115,30,1085,0,0,1036,10,26483,26448,1298,25150,0.05,0.95,
Detoxicare Molecular Diagnostics Laboratory,2020-06-11,1256,1256,46,1210,0,0,1780,10,27739,27704,1344,26360,0.05,0.95,
Detoxicare Molecular Diagnostics Laboratory,2020-06-12,1468,1468,75,1393,0,0,2312,12,29207,29172,1419,27753,0.05,0.95,
Detoxicare Molecular Diagnostics Laboratory,2020-06-13,1922,1922,96,1826,0,0,1610,4,31129,31094,1515,29579,0.05,0.95,
Detoxicare Molecular Diagnostics Laboratory,2020-06-14,1100,1099,58,1041,0,1,1490,4,32229,32193,1573,30620,0.05,0.95,
Detoxicare Molecular Diagnostics Laboratory,2020-06-15,112,112,6,106,0,0,1378,8,32341,32305,1579,30726,0.05,0.95,
Detoxicare Molecular Diagnostics Laboratory,2020-06-16,1002,1002,40,962,0,0,1624,5,33343,33307,1619,31688,0.05,0.95,
Detoxicare Molecular Diagnostics Laboratory,2020-06-17,1569,1569,90,1479,0,0,1945,11,34912,34876,1709,33167,0.05,0.95,
Detoxicare Molecular Diagnostics Laboratory,2020-06-18,1386,1386,80,1306,0,0,1441,13,36298,36262,1789,34473,0.05,0.95,
Detoxicare Molecular Diagnostics Laboratory,2020-06-19,2572,2572,118,2454,0,0,869,16,38870,38834,1907,36927,0.05,0.95,
Detoxicare Molecular Diagnostics Laboratory,2020-06-20,2388,2388,142,2246,0,0,2481,9,41258,41222,2049,39173,0.05,0.95,
Detoxicare Molecular Diagnostics Laboratory,2020-06-21,2311,2311,142,2169,0,0,1830,6,43569,43533,2191,41342,0.05,0.95,
Detoxicare Molecular Diagnostics Laboratory,2020-06-22,416,416,15,401,0,0,1414,0,43985,43949,2206,41743,0.05,0.95,
Detoxicare Molecular Diagnostics Laboratory,2020-06-23,1278,1278,109,1169,0,0,2136,0,45263,45227,2315,42912,0.05,0.95,
Detoxicare Molecular Diagnostics Laboratory,2020-06-24,1750,1750,96,1654,0,0,1614,4,47013,46977,2411,44566,0.05,0.95,
Detoxicare Molecular Diagnostics Laboratory,2020-06-25,2136,2136,101,2035,0,0,1478,209,49149,49113,2512,46601,0.05,0.95,
Detoxicare Molecular Diagnostics Laboratory,2020-06-26,2431,2431,179,2252,0,0,1047,115,51580,51544,2691,48853,0.05,0.95,
Detoxicare Molecular Diagnostics Laboratory,2020-06-27,2167,2167,221,1946,0,0,2880,51,53747,53711,2912,50799,0.05,0.95,
Divine Word Hospital,2020-05-18,86,31,0,31,0,0,45,,86,31,0,31,0.0,1.0,
Divine Word Hospital,2020-05-19,1,1,0,1,0,0,2000,0,87,32,0,32,0.0,1.0,
Divine Word Hospital,2020-05-20,21,21,0,21,0,0,1959,37,108,53,0,53,0.0,1.0,
Divine Word Hospital,2020-05-21,74,74,0,74,0,0,1875,91,182,127,0,127,0.0,1.0,
Divine Word Hospital,2020-05-22,77,77,0,77,0,0,1798,10,259,204,0,204,0.0,1.0,
Divine Word Hospital,2020-05-23,,,,,,,,,259,204,0,204,0.0,1.0,
Divine Word Hospital,2020-05-24,,,,,,,,,259,204,0,204,0.0,1.0,
Divine Word Hospital,2020-05-25,24,24,0,24,0,0,1773,107,283,228,0,228,0.0,1.0,
Divine Word Hospital,2020-05-26,40,40,0,40,0,0,1733,0,323,268,0,268,0.0,1.0,
Divine Word Hospital,2020-05-27,43,43,2,41,0,0,1573,84,366,311,2,309,0.01,0.99,
Divine Word Hospital,2020-05-28,29,29,0,29,0,0,1525,0,395,340,2,338,0.01,0.99,
Divine Word Hospital,2020-05-29,48,42,1,41,0,6,1477,0,443,382,3,379,0.01,0.99,
Divine Word Hospital,2020-05-30,165,165,1,164,0,2,1357,0,608,547,4,543,0.01,0.99,
Divine Word Hospital,2020-05-31,,,,,,,,,608,547,4,543,0.01,0.99,
Divine Word Hospital,2020-06-01,77,77,2,75,0,5,1224,0,685,624,6,618,0.01,0.99,
Divine Word Hospital,2020-06-02,93,93,0,93,0,0,978,0,778,717,6,711,0.01,0.99,
Divine Word Hospital,2020-06-03,31,31,0,31,0,1,1004,0,809,748,6,742,0.01,0.99,
Divine Word Hospital,2020-06-04,91,91,0,91,0,0,913,0,900,839,6,833,0.01,0.99,
Divine Word Hospital,2020-06-05,89,89,2,87,0,1,869,0,989,928,8,920,0.01,0.99,
Divine Word Hospital,2020-06-06,,,,,,,,,989,928,8,920,0.01,0.99,
Divine Word Hospital,2020-06-07,,,,,,,,,989,928,8,920,0.01,0.99,
Divine Word Hospital,2020-06-08,82,82,1,81,0,0,750,0,1071,1010,9,1001,0.01,0.99,
Divine Word Hospital,2020-06-09,65,65,3,62,0,1,681,0,1136,1075,12,1063,0.01,0.99,
Divine Word Hospital,2020-06-10,54,54,0,54,0,14,595,0,1190,1129,12,1117,0.01,0.99,
Divine Word Hospital,2020-06-11,38,38,0,38,0,55,457,0,1228,1167,12,1155,0.01,0.99,For Review
Divine Word Hospital,2020-06-12,129,129,1,128,0,1,372,0,1357,1296,13,1283,0.01,0.99,
Divine Word Hospital,2020-06-13,74,74,2,72,0,0,294,0,1431,1370,15,1355,0.01,0.99,
Divine Word Hospital,2020-06-14,0,0,0,0,0,0,294,0,1431,1370,15,1355,0.01,0.99,
Divine Word Hospital,2020-06-15,124,124,0,124,0,11,199,0,1555,1494,15,1479,0.01,0.99,
Divine Word Hospital,2020-06-16,,,,,,,,,1555,1494,15,1479,0.01,0.99,
Divine Word Hospital,2020-06-17,129,129,5,124,0,6,1550,88,1684,1623,20,1603,0.01,0.99,
Divine Word Hospital,2020-06-18,,,,,,,,,1684,1623,20,1603,0.01,0.99,
Divine Word Hospital,2020-06-19,,,,,,,,,1684,1623,20,1603,0.01,0.99,
Divine Word Hospital,2020-06-20,,,,,,,,,1684,1623,20,1603,0.01,0.99,
Divine Word Hospital,2020-06-21,,,,,,,,,1684,1623,20,1603,0.01,0.99,
Divine Word Hospital,2020-06-22,,,,,,,,,1684,1623,20,1603,0.01,0.99,
Divine Word Hospital,2020-06-23,,,,,,,,,1684,1623,20,1603,0.01,0.99,
Divine Word Hospital,2020-06-24,,,,,,,,,1684,1623,20,1603,0.01,0.99,
Divine Word Hospital,2020-06-25,,,,,,,,,1684,1623,20,1603,0.01,0.99,
Divine Word Hospital,2020-06-26,,,,,,,,,1684,1623,20,1603,0.01,0.99,
Divine Word Hospital,2020-06-27,,,,,,,,,1684,1623,20,1603,0.01,0.99,
Dr. Arturo Pingoy Medical Center GeneXpert Laboratory,2020-06-06,0,0,0,0,0,0,1437,0,0,0,0,0,,,
Dr. Arturo Pingoy Medical Center GeneXpert Laboratory,2020-06-07,,,,,,,,,0,0,0,0,,,
Dr. Arturo Pingoy Medical Center GeneXpert Laboratory,2020-06-08,12,12,0,12,0,0,1401,0,12,12,0,12,0.0,1.0,
Dr. Arturo Pingoy Medical Center GeneXpert Laboratory,2020-06-09,,,,,,,,,12,12,0,12,0.0,1.0,
Dr. Arturo Pingoy Medical Center GeneXpert Laboratory,2020-06-10,40,40,0,40,0,0,1361,0,52,52,0,52,0.0,1.0,
Dr. Arturo Pingoy Medical Center GeneXpert Laboratory,2020-06-11,,,,,,,,,52,52,0,52,0.0,1.0,
Dr. Arturo Pingoy Medical Center GeneXpert Laboratory,2020-06-12,48,44,2,42,0,4,1313,0,100,96,2,94,0.02,0.98,
Dr. Arturo Pingoy Medical Center GeneXpert Laboratory,2020-06-13,24,24,2,22,0,0,1289,0,124,120,4,116,0.03,0.97,
Dr. Arturo Pingoy Medical Center GeneXpert Laboratory,2020-06-14,0,0,0,0,0,0,1289,0,124,120,4,116,0.03,0.97,
Dr. Arturo Pingoy Medical Center GeneXpert Laboratory,2020-06-15,15,15,2,13,0,0,1274,0,139,135,6,129,0.04,0.96,
Dr. Arturo Pingoy Medical Center GeneXpert Laboratory,2020-06-16,13,12,1,11,0,1,1265,0,152,147,7,140,0.05,0.95,
Dr. Arturo Pingoy Medical Center GeneXpert Laboratory,2020-06-17,36,36,4,32,0,0,1225,0,188,183,11,172,0.06,0.94,
Dr. Arturo Pingoy Medical Center GeneXpert Laboratory,2020-06-18,0,0,0,0,0,0,1225,0,188,183,11,172,0.06,0.94,
Dr. Arturo Pingoy Medical Center GeneXpert Laboratory,2020-06-19,44,44,3,41,0,0,1181,0,232,227,14,213,0.06,0.94,
Dr. Arturo Pingoy Medical Center GeneXpert Laboratory,2020-06-20,0,0,0,0,0,0,1182,0,232,227,14,213,0.06,0.94,
Dr. Arturo Pingoy Medical Center GeneXpert Laboratory,2020-06-21,0,0,0,0,0,0,1181,0,232,227,14,213,0.06,0.94,
Dr. Arturo Pingoy Medical Center GeneXpert Laboratory,2020-06-22,13,13,0,13,0,0,1168,0,245,240,14,226,0.06,0.94,
Dr. Arturo Pingoy Medical Center GeneXpert Laboratory,2020-06-23,0,0,0,0,0,0,1168,0,245,240,14,226,0.06,0.94,
Dr. Arturo Pingoy Medical Center GeneXpert Laboratory,2020-06-24,15,14,0,14,0,0,1153,0,260,254,14,240,0.06,0.94,
Dr. Arturo Pingoy Medical Center GeneXpert Laboratory,2020-06-25,14,14,0,14,0,0,1139,0,274,268,14,254,0.05,0.95,
Dr. Arturo Pingoy Medical Center GeneXpert Laboratory,2020-06-26,5,5,0,5,0,0,1794,0,279,273,14,259,0.05,0.95,
Dr. Arturo Pingoy Medical Center GeneXpert Laboratory,2020-06-27,0,0,0,0,0,0,1794,0,279,273,14,259,0.05,0.95,
Dr. Jose N. Rodriguez Memorial Hospital and Sanitarium (TALA) GeneXpert Laboratory,2020-05-26,0,0,0,0,0,0,1200,0,0,0,0,0,,,
Dr. Jose N. Rodriguez Memorial Hospital and Sanitarium (TALA) GeneXpert Laboratory,2020-05-27,1,1,0,1,0,0,1380,0,1,1,0,1,0.0,1.0,
Dr. Jose N. Rodriguez Memorial Hospital and Sanitarium (TALA) GeneXpert Laboratory,2020-05-28,31,31,11,20,3,0,1348,0,32,32,11,21,0.34,0.66,
Dr. Jose N. Rodriguez Memorial Hospital and Sanitarium (TALA) GeneXpert Laboratory,2020-05-29,7,6,0,6,0,1,1342,0,39,38,11,27,0.29,0.71,
Dr. Jose N. Rodriguez Memorial Hospital and Sanitarium (TALA) GeneXpert Laboratory,2020-05-30,5,5,2,3,0,0,1334,0,44,43,13,30,0.3,0.7,
Dr. Jose N. Rodriguez Memorial Hospital and Sanitarium (TALA) GeneXpert Laboratory,2020-05-31,0,0,0,0,0,0,1333,0,44,43,13,30,0.3,0.7,
Dr. Jose N. Rodriguez Memorial Hospital and Sanitarium (TALA) GeneXpert Laboratory,2020-06-01,11,11,1,10,0,0,1322,0,55,54,14,40,0.26,0.74,
Dr. Jose N. Rodriguez Memorial Hospital and Sanitarium (TALA) GeneXpert Laboratory,2020-06-02,12,11,2,9,1,0,1310,0,67,65,16,49,0.25,0.75,
Dr. Jose N. Rodriguez Memorial Hospital and Sanitarium (TALA) GeneXpert Laboratory,2020-06-03,30,27,9,18,2,0,1280,0,97,92,25,67,0.27,0.73,
Dr. Jose N. Rodriguez Memorial Hospital and Sanitarium (TALA) GeneXpert Laboratory,2020-06-04,27,26,10,16,1,0,1251,0,124,118,35,83,0.3,0.7,
Dr. Jose N. Rodriguez Memorial Hospital and Sanitarium (TALA) GeneXpert Laboratory,2020-06-05,23,23,12,11,0,0,1228,0,147,141,47,94,0.33,0.67,
Dr. Jose N. Rodriguez Memorial Hospital and Sanitarium (TALA) GeneXpert Laboratory,2020-06-06,18,18,5,13,0,0,1210,0,165,159,52,107,0.33,0.67,
Dr. Jose N. Rodriguez Memorial Hospital and Sanitarium (TALA) GeneXpert Laboratory,2020-06-07,0,0,0,0,0,0,1210,0,165,159,52,107,0.33,0.67,
Dr. Jose N. Rodriguez Memorial Hospital and Sanitarium (TALA) GeneXpert Laboratory,2020-06-08,41,39,18,21,1,0,1408,0,206,198,70,128,0.35,0.65,
Dr. Jose N. Rodriguez Memorial Hospital and Sanitarium (TALA) GeneXpert Laboratory,2020-06-09,11,10,5,5,1,0,1397,0,217,208,75,133,0.36,0.64,
Dr. Jose N. Rodriguez Memorial Hospital and Sanitarium (TALA) GeneXpert Laboratory,2020-06-10,9,9,7,2,0,0,1389,0,226,217,82,135,0.38,0.62,
Dr. Jose N. Rodriguez Memorial Hospital and Sanitarium (TALA) GeneXpert Laboratory,2020-06-11,4,3,0,3,1,0,1383,0,230,220,82,138,0.37,0.63,
Dr. Jose N. Rodriguez Memorial Hospital and Sanitarium (TALA) GeneXpert Laboratory,2020-06-12,17,17,7,10,0,0,1366,0,247,237,89,148,0.38,0.62,
Dr. Jose N. Rodriguez Memorial Hospital and Sanitarium (TALA) GeneXpert Laboratory,2020-06-13,44,43,28,15,1,0,1322,0,291,280,117,163,0.42,0.58,
Dr. Jose N. Rodriguez Memorial Hospital and Sanitarium (TALA) GeneXpert Laboratory,2020-06-14,0,0,0,0,0,0,1322,0,291,280,117,163,0.42,0.58,
Dr. Jose N. Rodriguez Memorial Hospital and Sanitarium (TALA) GeneXpert Laboratory,2020-06-15,21,20,9,11,1,0,1301,0,312,300,126,174,0.42,0.58,
Dr. Jose N. Rodriguez Memorial Hospital and Sanitarium (TALA) GeneXpert Laboratory,2020-06-16,40,35,20,15,2,1,1261,0,352,335,146,189,0.44,0.56,
Dr. Jose N. Rodriguez Memorial Hospital and Sanitarium (TALA) GeneXpert Laboratory,2020-06-17,12,12,2,10,0,0,1249,0,364,347,148,199,0.43,0.57,
Dr. Jose N. Rodriguez Memorial Hospital and Sanitarium (TALA) GeneXpert Laboratory,2020-06-18,15,14,3,11,1,0,1234,0,379,361,151,210,0.42,0.58,
Dr. Jose N. Rodriguez Memorial Hospital and Sanitarium (TALA) GeneXpert Laboratory,2020-06-19,36,35,13,22,0,0,1198,0,415,396,164,232,0.41,0.59,
Dr. Jose N. Rodriguez Memorial Hospital and Sanitarium (TALA) GeneXpert Laboratory,2020-06-20,19,18,10,8,0,0,1179,0,434,414,174,240,0.42,0.58,
Dr. Jose N. Rodriguez Memorial Hospital and Sanitarium (TALA) GeneXpert Laboratory,2020-06-21,0,0,0,0,0,0,1179,0,434,414,174,240,0.42,0.58,
Dr. Jose N. Rodriguez Memorial Hospital and Sanitarium (TALA) GeneXpert Laboratory,2020-06-22,48,45,18,27,2,0,1131,0,482,459,192,267,0.42,0.58,
Dr. Jose N. Rodriguez Memorial Hospital and Sanitarium (TALA) GeneXpert Laboratory,2020-06-23,16,16,11,5,0,0,1115,0,498,475,203,272,0.43,0.57,
Dr. Jose N. Rodriguez Memorial Hospital and Sanitarium (TALA) GeneXpert Laboratory,2020-06-24,11,11,4,7,0,0,1104,0,509,486,207,279,0.43,0.57,
Dr. Jose N. Rodriguez Memorial Hospital and Sanitarium (TALA) GeneXpert Laboratory,2020-06-25,25,24,12,12,1,0,1079,0,534,510,219,291,0.43,0.57,
Dr. Jose N. Rodriguez Memorial Hospital and Sanitarium (TALA) GeneXpert Laboratory,2020-06-26,29,29,11,18,0,0,1050,0,563,539,230,309,0.43,0.57,
Dr. Jose N. Rodriguez Memorial Hospital and Sanitarium (TALA) GeneXpert Laboratory,2020-06-27,12,11,5,6,1,0,1038,0,575,550,235,315,0.43,0.57,
Eastern Visayas Regional Covid Testing Center,2020-05-11,8,8,0,8,,,,,8,8,0,8,0.0,1.0,
Eastern Visayas Regional Covid Testing Center,2020-05-12,17,16,0,16,,,,,25,24,0,24,0.0,1.0,
Eastern Visayas Regional Covid Testing Center,2020-05-13,37,37,0,37,,,300,,62,61,0,61,0.0,1.0,
Eastern Visayas Regional Covid Testing Center,2020-05-14,119,119,4,115,,,200,,181,180,4,176,0.02,0.98,
Eastern Visayas Regional Covid Testing Center,2020-05-15,70,70,1,69,,,180,,251,250,5,245,0.02,0.98,
Eastern Visayas Regional Covid Testing Center,2020-05-16,90,90,1,89,0,0,48,,341,340,6,334,0.02,0.98,
Eastern Visayas Regional Covid Testing Center,2020-05-17,,0,0,0,0,0,,,341,340,6,334,0.02,0.98,For Review
Eastern Visayas Regional Covid Testing Center,2020-05-18,91,91,0,91,0,0,0,,432,431,6,425,0.01,0.99,
Eastern Visayas Regional Covid Testing Center,2020-05-19,0,0,0,0,0,0,1,599,432,431,6,425,0.01,0.99,
Eastern Visayas Regional Covid Testing Center,2020-05-20,0,0,0,0,0,0,0,547,432,431,6,425,0.01,0.99,
Eastern Visayas Regional Covid Testing Center,2020-05-21,53,53,0,53,0,0,3400,685,485,484,6,478,0.01,0.99,
Eastern Visayas Regional Covid Testing Center,2020-05-22,186,183,0,183,0,0,3400,500,671,667,6,661,0.01,0.99,
Eastern Visayas Regional Covid Testing Center,2020-05-23,,,,,,,,,671,667,6,661,0.01,0.99,
Eastern Visayas Regional Covid Testing Center,2020-05-24,0,0,0,0,0,0,3400,500,671,667,6,661,0.01,0.99,
Eastern Visayas Regional Covid Testing Center,2020-05-25,92,92,2,90,0,0,3120,526,763,759,8,751,0.01,0.99,
Eastern Visayas Regional Covid Testing Center,2020-05-26,156,156,0,156,0,0,2900,323,919,915,8,907,0.01,0.99,
Eastern Visayas Regional Covid Testing Center,2020-05-27,180,180,1,179,0,0,2700,317,1099,1095,9,1086,0.01,0.99,
Eastern Visayas Regional Covid Testing Center,2020-05-28,178,178,5,173,0,0,2500,200,1277,1273,14,1259,0.01,0.99,
Eastern Visayas Regional Covid Testing Center,2020-05-29,160,159,2,157,0,0,3000,0,1437,1432,16,1416,0.01,0.99,
Eastern Visayas Regional Covid Testing Center,2020-05-30,0,0,0,0,0,0,14600,0,1437,1432,16,1416,0.01,0.99,
Eastern Visayas Regional Covid Testing Center,2020-05-31,0,0,0,0,0,0,4600,0,1437,1432,16,1416,0.01,0.99,
Eastern Visayas Regional Covid Testing Center,2020-06-01,56,56,1,55,0,0,5056,0,1493,1488,17,1471,0.01,0.99,
Eastern Visayas Regional Covid Testing Center,2020-06-02,278,277,2,275,0,0,4500,0,1771,1765,19,1746,0.01,0.99,
Eastern Visayas Regional Covid Testing Center,2020-06-03,111,111,2,109,0,0,4390,0,1882,1876,21,1855,0.01,0.99,
Eastern Visayas Regional Covid Testing Center,2020-06-04,183,183,1,182,0,0,4700,0,2065,2059,22,2037,0.01,0.99,
Eastern Visayas Regional Covid Testing Center,2020-06-05,90,90,1,89,0,0,4600,0,2155,2149,23,2126,0.01,0.99,
Eastern Visayas Regional Covid Testing Center,2020-06-06,0,0,0,0,0,0,4600,0,2155,2149,23,2126,0.01,0.99,
Eastern Visayas Regional Covid Testing Center,2020-06-07,0,0,0,0,0,0,4600,0,2155,2149,23,2126,0.01,0.99,
Eastern Visayas Regional Covid Testing Center,2020-06-08,435,434,1,433,1,0,3800,0,2590,2583,24,2559,0.01,0.99,
Eastern Visayas Regional Covid Testing Center,2020-06-09,195,195,18,177,0,0,3600,0,2785,2778,42,2736,0.02,0.98,
Eastern Visayas Regional Covid Testing Center,2020-06-10,224,224,4,220,0,0,3500,0,3009,3002,46,2956,0.02,0.98,
Eastern Visayas Regional Covid Testing Center,2020-06-11,185,185,14,171,0,0,3000,0,3194,3187,60,3127,0.02,0.98,
Eastern Visayas Regional Covid Testing Center,2020-06-12,223,221,42,179,0,0,3000,0,3417,3408,102,3306,0.03,0.97,
Eastern Visayas Regional Covid Testing Center,2020-06-13,245,245,67,178,0,0,3000,0,3662,3653,169,3484,0.05,0.95,
Eastern Visayas Regional Covid Testing Center,2020-06-14,0,0,0,0,0,0,3500,0,3662,3653,169,3484,0.05,0.95,
Eastern Visayas Regional Covid Testing Center,2020-06-15,71,71,5,66,0,0,3400,0,3733,3724,174,3550,0.05,0.95,
Eastern Visayas Regional Covid Testing Center,2020-06-16,270,270,60,210,0,0,3500,0,4003,3994,234,3760,0.06,0.94,
Eastern Visayas Regional Covid Testing Center,2020-06-17,414,414,73,341,0,0,3500,0,4417,4408,307,4101,0.07,0.93,
Eastern Visayas Regional Covid Testing Center,2020-06-18,265,265,2,263,0,0,3300,0,4682,4673,309,4364,0.07,0.93,
Eastern Visayas Regional Covid Testing Center,2020-06-19,324,324,13,311,0,0,5000,200,5006,4997,322,4675,0.06,0.94,
Eastern Visayas Regional Covid Testing Center,2020-06-20,247,247,30,217,0,0,4000,900,5253,5244,352,4892,0.07,0.93,
Eastern Visayas Regional Covid Testing Center,2020-06-21,0,0,0,0,0,0,4000,1600,5253,5244,352,4892,0.07,0.93,
Eastern Visayas Regional Covid Testing Center,2020-06-22,222,222,35,187,0,0,3800,1400,5475,5466,387,5079,0.07,0.93,
Eastern Visayas Regional Covid Testing Center,2020-06-23,278,278,3,275,0,0,3500,1000,5753,5744,390,5354,0.07,0.93,
Eastern Visayas Regional Covid Testing Center,2020-06-24,374,374,10,364,0,0,4000,732,6127,6118,400,5718,0.07,0.93,
Eastern Visayas Regional Covid Testing Center,2020-06-25,165,165,16,149,0,0,1500,1100,6292,6283,416,5867,0.07,0.93,
Eastern Visayas Regional Covid Testing Center,2020-06-26,333,333,26,307,0,0,1200,500,6625,6616,442,6174,0.07,0.93,
Eastern Visayas Regional Covid Testing Center,2020-06-27,,,,,,,,,6625,6616,442,6174,0.07,0.93,
Greencity Medical Center,2020-06-16,81,0,0,0,0,0,5919,0,81,0,0,0,,,
Greencity Medical Center,2020-06-17,67,2,1,1,0,0,5852,0,148,2,1,1,0.5,0.5,
Greencity Medical Center,2020-06-18,59,2,0,2,0,0,5793,0,207,4,1,3,0.25,0.75,
Greencity Medical Center,2020-06-19,92,0,0,0,0,64,5637,64,299,4,1,3,0.25,0.75,
Greencity Medical Center,2020-06-20,73,3,0,3,0,0,5564,0,372,7,1,6,0.14,0.86,
Greencity Medical Center,2020-06-21,49,2,2,0,0,0,5515,0,421,9,3,6,0.33,0.67,
Greencity Medical Center,2020-06-22,0,0,0,0,0,0,5677,0,421,9,3,6,0.33,0.67,
Greencity Medical Center,2020-06-23,40,0,0,0,0,2,5634,0,461,9,3,6,0.33,0.67,
Greencity Medical Center,2020-06-24,62,0,0,0,0,0,5569,0,523,9,3,6,0.33,0.67,
Greencity Medical Center,2020-06-25,47,0,0,0,0,0,5519,0,570,9,3,6,0.33,0.67,
Greencity Medical Center,2020-06-26,46,46,1,45,1,0,5470,0,616,55,4,51,0.07,0.93,
Greencity Medical Center,2020-06-27,69,69,0,69,0,0,5398,0,685,124,4,120,0.03,0.97,
Hi-Precision Diagnostics (QC),2020-06-04,90,86,0,86,0,3,1260,4,90,86,0,86,0.0,1.0,
Hi-Precision Diagnostics (QC),2020-06-05,92,85,1,84,0,0,1248,7,182,171,1,170,0.01,0.99,
Hi-Precision Diagnostics (QC),2020-06-06,91,89,0,89,0,0,864,23,273,260,1,259,0.0,1.0,
Hi-Precision Diagnostics (QC),2020-06-07,91,89,0,89,0,0,864,23,364,349,1,348,0.0,1.0,
Hi-Precision Diagnostics (QC),2020-06-08,0,0,0,0,0,0,0,0,364,349,1,348,0.0,1.0,
Hi-Precision Diagnostics (QC),2020-06-09,0,0,0,0,0,0,864,23,364,349,1,348,0.0,1.0,
Hi-Precision Diagnostics (QC),2020-06-10,92,88,1,87,0,0,768,32,456,437,2,435,0.0,1.0,
Hi-Precision Diagnostics (QC),2020-06-11,155,142,2,140,0,0,576,1,611,579,4,575,0.01,0.99,
Hi-Precision Diagnostics (QC),2020-06-12,0,0,0,0,0,0,576,3,611,579,4,575,0.01,0.99,
Hi-Precision Diagnostics (QC),2020-06-13,0,0,0,0,0,0,576,3,611,579,4,575,0.01,0.99,
Hi-Precision Diagnostics (QC),2020-06-14,79,78,1,77,0,0,576,1,690,657,5,652,0.01,0.99,
Hi-Precision Diagnostics (QC),2020-06-15,0,0,0,0,0,0,576,1,690,657,5,652,0.01,0.99,
Hi-Precision Diagnostics (QC),2020-06-16,0,0,0,0,0,0,576,1,690,657,5,652,0.01,0.99,
Hi-Precision Diagnostics (QC),2020-06-17,89,86,1,85,0,0,480,1,779,743,6,737,0.01,0.99,
Hi-Precision Diagnostics (QC),2020-06-18,94,86,0,86,0,0,384,0,873,829,6,823,0.01,0.99,
Hi-Precision Diagnostics (QC),2020-06-19,59,51,5,46,0,0,288,0,932,880,11,869,0.01,0.99,
Hi-Precision Diagnostics (QC),2020-06-20,0,0,0,0,0,0,288,0,932,880,11,869,0.01,0.99,
Hi-Precision Diagnostics (QC),2020-06-21,0,0,0,0,0,0,288,0,932,880,11,869,0.01,0.99,
Hi-Precision Diagnostics (QC),2020-06-22,0,0,0,0,0,0,288,0,932,880,11,869,0.01,0.99,
Hi-Precision Diagnostics (QC),2020-06-23,0,0,0,0,0,0,288,0,932,880,11,869,0.01,0.99,
Hi-Precision Diagnostics (QC),2020-06-24,135,128,4,124,0,0,1152,2,1067,1008,15,993,0.01,0.99,
Hi-Precision Diagnostics (QC),2020-06-25,84,23,0,23,0,0,1536,2,1151,1031,15,1016,0.01,0.99,
Hi-Precision Diagnostics (QC),2020-06-26,95,92,13,79,0,0,1440,1,1246,1123,28,1095,0.02,0.98,
Hi-Precision Diagnostics (QC),2020-06-27,,,,,,,,,1246,1123,28,1095,0.02,0.98,
Ilocos Training and Regional Medical Center,2020-05-27,0,0,0,0,0,0,794,0,0,0,0,0,,,
Ilocos Training and Regional Medical Center,2020-05-28,38,38,0,38,0,0,711,0,38,38,0,38,0.0,1.0,
Ilocos Training and Regional Medical Center,2020-05-29,41,41,0,41,0,0,670,0,79,79,0,79,0.0,1.0,
Ilocos Training and Regional Medical Center,2020-05-30,49,49,0,49,0,0,609,0,128,128,0,128,0.0,1.0,
Ilocos Training and Regional Medical Center,2020-05-31,33,33,0,33,0,0,572,0,161,161,0,161,0.0,1.0,
Ilocos Training and Regional Medical Center,2020-06-01,46,46,0,46,0,0,539,0,207,207,0,207,0.0,1.0,
Ilocos Training and Regional Medical Center,2020-06-02,54,54,0,54,0,0,481,0,261,261,0,261,0.0,1.0,
Ilocos Training and Regional Medical Center,2020-06-03,0,0,0,0,0,0,246,0,261,261,0,261,0.0,1.0,
Ilocos Training and Regional Medical Center,2020-06-04,184,184,0,184,0,0,50,0,445,445,0,445,0.0,1.0,
Ilocos Training and Regional Medical Center,2020-06-05,67,67,0,67,0,0,200,0,512,512,0,512,0.0,1.0,
Ilocos Training and Regional Medical Center,2020-06-06,82,82,0,82,0,0,118,0,594,594,0,594,0.0,1.0,
Ilocos Training and Regional Medical Center,2020-06-07,36,36,0,36,0,0,5384,0,630,630,0,630,0.0,1.0,
Ilocos Training and Regional Medical Center,2020-06-08,55,55,0,55,0,0,5426,0,685,685,0,685,0.0,1.0,
Ilocos Training and Regional Medical Center,2020-06-09,68,68,0,68,0,0,5355,0,753,753,0,753,0.0,1.0,
Ilocos Training and Regional Medical Center,2020-06-10,106,106,0,106,0,0,7995,0,859,859,0,859,0.0,1.0,
Ilocos Training and Regional Medical Center,2020-06-11,76,76,0,76,0,0,7916,0,935,935,0,935,0.0,1.0,
Ilocos Training and Regional Medical Center,2020-06-12,180,180,0,180,0,0,7720,0,1115,1115,0,1115,0.0,1.0,
Ilocos Training and Regional Medical Center,2020-06-13,58,58,0,58,0,0,7644,0,1173,1173,0,1173,0.0,1.0,
Ilocos Training and Regional Medical Center,2020-06-14,79,79,0,79,0,0,7520,0,1252,1252,0,1252,0.0,1.0,
Ilocos Training and Regional Medical Center,2020-06-15,43,43,0,43,0,0,7474,0,1295,1295,0,1295,0.0,1.0,
Ilocos Training and Regional Medical Center,2020-06-16,265,265,0,265,0,0,7500,0,1560,1560,0,1560,0.0,1.0,
Ilocos Training and Regional Medical Center,2020-06-17,174,174,0,174,0,0,7311,0,1734,1734,0,1734,0.0,1.0,
Ilocos Training and Regional Medical Center,2020-06-18,215,215,0,215,0,0,7058,0,1949,1949,0,1949,0.0,1.0,
Ilocos Training and Regional Medical Center,2020-06-19,92,92,0,92,0,0,6963,0,2041,2041,0,2041,0.0,1.0,
Ilocos Training and Regional Medical Center,2020-06-20,171,171,0,171,0,0,6761,0,2212,2212,0,2212,0.0,1.0,
Ilocos Training and Regional Medical Center,2020-06-21,96,96,0,96,0,0,6652,0,2308,2308,0,2308,0.0,1.0,
Ilocos Training and Regional Medical Center,2020-06-22,71,71,0,71,0,0,6578,0,2379,2379,0,2379,0.0,1.0,
Ilocos Training and Regional Medical Center,2020-06-23,423,423,0,423,0,0,6351,0,2802,2802,0,2802,0.0,1.0,
Ilocos Training and Regional Medical Center,2020-06-24,115,115,0,115,0,0,6221,0,2917,2917,0,2917,0.0,1.0,
Ilocos Training and Regional Medical Center,2020-06-25,185,185,1,184,0,0,6022,0,3102,3102,1,3101,0.0,1.0,
Ilocos Training and Regional Medical Center,2020-06-26,183,183,0,183,0,0,5828,0,3285,3285,1,3284,0.0,1.0,
Ilocos Training and Regional Medical Center,2020-06-27,196,196,0,196,0,0,5600,0,3481,3481,1,3480,0.0,1.0,
Jose B. Lingad Memorial General Hospital,2020-05-12,90,90,1,89,,,44650,,90,90,1,89,0.01,0.99,
Jose B. Lingad Memorial General Hospital,2020-05-13,93,93,0,93,,,44557,,183,183,1,182,0.01,0.99,
Jose B. Lingad Memorial General Hospital,2020-05-14,185,185,4,181,,,44372,,368,368,5,363,0.01,0.99,
Jose B. Lingad Memorial General Hospital,2020-05-15,368,358,0,358,,,44004,,736,726,5,721,0.01,0.99,
Jose B. Lingad Memorial General Hospital,2020-05-16,0,0,0,0,0,0,44004,,736,726,5,721,0.01,0.99,
Jose B. Lingad Memorial General Hospital,2020-05-17,0,0,0,0,0,0,44004,,736,726,5,721,0.01,0.99,
Jose B. Lingad Memorial General Hospital,2020-05-18,275,261,10,251,0,0,43729,,1011,987,15,972,0.02,0.98,
Jose B. Lingad Memorial General Hospital,2020-05-19,183,183,0,183,0,0,43546,0,1194,1170,15,1155,0.01,0.99,
Jose B. Lingad Memorial General Hospital,2020-05-20,184,180,0,180,0,0,43545,0,1378,1350,15,1335,0.01,0.99,
Jose B. Lingad Memorial General Hospital,2020-05-21,92,82,0,82,0,0,43453,0,1470,1432,15,1417,0.01,0.99,
Jose B. Lingad Memorial General Hospital,2020-05-22,92,88,2,86,0,0,43361,0,1562,1520,17,1503,0.01,0.99,
Jose B. Lingad Memorial General Hospital,2020-05-23,0,0,0,0,0,0,43361,0,1562,1520,17,1503,0.01,0.99,
Jose B. Lingad Memorial General Hospital,2020-05-24,0,0,0,0,0,0,43361,0,1562,1520,17,1503,0.01,0.99,
Jose B. Lingad Memorial General Hospital,2020-05-25,0,0,0,0,0,0,43361,0,1562,1520,17,1503,0.01,0.99,
Jose B. Lingad Memorial General Hospital,2020-05-26,368,337,1,336,0,0,42993,0,1930,1857,18,1839,0.01,0.99,
Jose B. Lingad Memorial General Hospital,2020-05-27,276,275,4,271,0,0,42717,0,2206,2132,22,2110,0.01,0.99,
Jose B. Lingad Memorial General Hospital,2020-05-28,92,91,0,91,0,0,42625,0,2298,2223,22,2201,0.01,0.99,
Jose B. Lingad Memorial General Hospital,2020-05-29,185,157,0,157,0,0,42440,0,2483,2380,22,2358,0.01,0.99,
Jose B. Lingad Memorial General Hospital,2020-05-30,0,0,0,0,0,0,42440,0,2483,2380,22,2358,0.01,0.99,
Jose B. Lingad Memorial General Hospital,2020-05-31,0,0,0,0,0,0,42440,0,2483,2380,22,2358,0.01,0.99,
Jose B. Lingad Memorial General Hospital,2020-06-01,185,159,4,155,0,0,42255,0,2668,2539,26,2513,0.01,0.99,
Jose B. Lingad Memorial General Hospital,2020-06-02,184,169,0,169,0,0,42071,0,2852,2708,26,2682,0.01,0.99,
Jose B. Lingad Memorial General Hospital,2020-06-03,460,437,2,435,0,0,41611,0,3312,3145,28,3117,0.01,0.99,
Jose B. Lingad Memorial General Hospital,2020-06-04,184,180,1,179,0,0,41427,0,3496,3325,29,3296,0.01,0.99,
Jose B. Lingad Memorial General Hospital,2020-06-05,92,80,0,80,0,0,41335,0,3588,3405,29,3376,0.01,0.99,
Jose B. Lingad Memorial General Hospital,2020-06-06,736,723,0,723,0,0,40599,0,4324,4128,29,4099,0.01,0.99,
Jose B. Lingad Memorial General Hospital,2020-06-07,0,0,0,0,0,0,40599,0,4324,4128,29,4099,0.01,0.99,
Jose B. Lingad Memorial General Hospital,2020-06-08,368,360,4,356,0,0,40231,0,4692,4488,33,4455,0.01,0.99,
Jose B. Lingad Memorial General Hospital,2020-06-09,92,88,0,88,0,0,40139,0,4784,4576,33,4543,0.01,0.99,
Jose B. Lingad Memorial General Hospital,2020-06-10,460,458,9,449,0,0,39679,0,5244,5034,42,4992,0.01,0.99,
Jose B. Lingad Memorial General Hospital,2020-06-11,184,176,4,172,0,0,39495,0,5428,5210,46,5164,0.01,0.99,
Jose B. Lingad Memorial General Hospital,2020-06-12,644,624,2,622,0,0,38851,0,6072,5834,48,5786,0.01,0.99,
Jose B. Lingad Memorial General Hospital,2020-06-13,92,92,0,92,0,0,38759,0,6164,5926,48,5878,0.01,0.99,
Jose B. Lingad Memorial General Hospital,2020-06-14,0,0,0,0,0,0,38759,0,6164,5926,48,5878,0.01,0.99,
Jose B. Lingad Memorial General Hospital,2020-06-15,552,550,4,546,0,0,38207,0,6716,6476,52,6424,0.01,0.99,
Jose B. Lingad Memorial General Hospital,2020-06-16,184,183,1,182,0,0,38025,0,6900,6659,53,6606,0.01,0.99,
Jose B. Lingad Memorial General Hospital,2020-06-17,642,630,3,627,0,0,37381,0,7542,7289,56,7233,0.01,0.99,
Jose B. Lingad Memorial General Hospital,2020-06-18,552,540,2,538,0,0,36829,0,8094,7829,58,7771,0.01,0.99,
Jose B. Lingad Memorial General Hospital,2020-06-19,552,516,2,514,0,0,36277,0,8646,8345,60,8285,0.01,0.99,
Jose B. Lingad Memorial General Hospital,2020-06-20,920,885,2,883,0,0,35357,0,9566,9230,62,9168,0.01,0.99,
Jose B. Lingad Memorial General Hospital,2020-06-21,368,363,2,361,0,0,34989,0,9934,9593,64,9529,0.01,0.99,
Jose B. Lingad Memorial General Hospital,2020-06-22,460,446,4,442,0,0,34872,0,10394,10039,68,9971,0.01,0.99,
Jose B. Lingad Memorial General Hospital,2020-06-23,1198,1178,17,1161,0,0,33674,0,11592,11217,85,11132,0.01,0.99,
Jose B. Lingad Memorial General Hospital,2020-06-24,184,184,8,176,0,0,33490,0,11776,11401,93,11308,0.01,0.99,
Jose B. Lingad Memorial General Hospital,2020-06-25,460,457,6,451,0,0,33030,0,12236,11858,99,11759,0.01,0.99,
Jose B. Lingad Memorial General Hospital,2020-06-26,368,368,8,360,0,0,32662,0,12604,12226,107,12119,0.01,0.99,
Jose B. Lingad Memorial General Hospital,2020-06-27,1288,1280,16,1264,0,0,31374,0,13892,13506,123,13383,0.01,0.99,
Lucena United Doctors Hospital and Medical Center,2020-05-19,24,24,0,24,0,0,300,0,24,24,0,24,0.0,1.0,
Lucena United Doctors Hospital and Medical Center,2020-05-20,10,10,0,10,0,0,288,0,34,34,0,34,0.0,1.0,
Lucena United Doctors Hospital and Medical Center,2020-05-21,19,19,0,19,0,0,267,0,53,53,0,53,0.0,1.0,
Lucena United Doctors Hospital and Medical Center,2020-05-22,28,28,2,26,0,0,237,0,81,81,2,79,0.02,0.98,
Lucena United Doctors Hospital and Medical Center,2020-05-23,,,,,,,,,81,81,2,79,0.02,0.98,
Lucena United Doctors Hospital and Medical Center,2020-05-24,,,,,,,,,81,81,2,79,0.02,0.98,
Lucena United Doctors Hospital and Medical Center,2020-05-25,53,53,3,50,0,0,179,0,134,134,5,129,0.04,0.96,
Lucena United Doctors Hospital and Medical Center,2020-05-26,53,53,1,52,0,0,122,0,187,187,6,181,0.03,0.97,
Lucena United Doctors Hospital and Medical Center,2020-05-27,47,46,5,41,0,0,50,0,234,233,11,222,0.05,0.95,
Lucena United Doctors Hospital and Medical Center,2020-05-28,44,44,0,44,0,0,160,0,278,277,11,266,0.04,0.96,
Lucena United Doctors Hospital and Medical Center,2020-05-29,67,65,1,64,0,0,89,0,345,342,12,330,0.04,0.96,
Lucena United Doctors Hospital and Medical Center,2020-05-30,0,0,0,0,0,0,89,0,345,342,12,330,0.04,0.96,
Lucena United Doctors Hospital and Medical Center,2020-05-31,0,0,0,0,0,0,89,0,345,342,12,330,0.04,0.96,
Lucena United Doctors Hospital and Medical Center,2020-06-01,46,46,2,44,0,0,675,21,391,388,14,374,0.04,0.96,
Lucena United Doctors Hospital and Medical Center,2020-06-02,67,67,1,66,0,0,604,0,458,455,15,440,0.03,0.97,
Lucena United Doctors Hospital and Medical Center,2020-06-03,95,94,0,94,0,0,505,0,553,549,15,534,0.03,0.97,
Lucena United Doctors Hospital and Medical Center,2020-06-04,89,89,1,88,0,0,412,0,642,638,16,622,0.03,0.97,
Lucena United Doctors Hospital and Medical Center,2020-06-05,105,104,1,103,0,0,302,0,747,742,17,725,0.02,0.98,
Lucena United Doctors Hospital and Medical Center,2020-06-06,0,0,0,0,0,0,302,0,747,742,17,725,0.02,0.98,
Lucena United Doctors Hospital and Medical Center,2020-06-07,0,0,0,0,0,0,302,0,747,742,17,725,0.02,0.98,
Lucena United Doctors Hospital and Medical Center,2020-06-08,80,80,12,68,0,0,217,25,827,822,29,793,0.04,0.96,
Lucena United Doctors Hospital and Medical Center,2020-06-09,71,71,0,71,0,0,142,0,898,893,29,864,0.03,0.97,
Lucena United Doctors Hospital and Medical Center,2020-06-10,35,35,0,35,0,0,105,0,933,928,29,899,0.03,0.97,
Lucena United Doctors Hospital and Medical Center,2020-06-11,104,103,0,103,0,0,150,0,1037,1031,29,1002,0.03,0.97,
Lucena United Doctors Hospital and Medical Center,2020-06-12,113,112,0,112,0,0,37,0,1150,1143,29,1114,0.03,0.97,
Lucena United Doctors Hospital and Medical Center,2020-06-13,0,0,0,0,0,0,37,0,1150,1143,29,1114,0.03,0.97,
Lucena United Doctors Hospital and Medical Center,2020-06-14,0,0,0,0,0,0,37,0,1150,1143,29,1114,0.03,0.97,
Lucena United Doctors Hospital and Medical Center,2020-06-15,76,75,0,75,0,0,0,17,1226,1218,29,1189,0.02,0.98,
Lucena United Doctors Hospital and Medical Center,2020-06-16,83,83,0,83,0,0,257,0,1309,1301,29,1272,0.02,0.98,
Lucena United Doctors Hospital and Medical Center,2020-06-17,102,100,2,98,0,0,151,0,1411,1401,31,1370,0.02,0.98,
Lucena United Doctors Hospital and Medical Center,2020-06-18,110,104,3,101,0,0,187,0,1521,1505,34,1471,0.02,0.98,
Lucena United Doctors Hospital and Medical Center,2020-06-19,104,102,0,102,0,0,79,0,1625,1607,34,1573,0.02,0.98,
Lucena United Doctors Hospital and Medical Center,2020-06-20,0,0,0,0,0,0,79,0,1625,1607,34,1573,0.02,0.98,
Lucena United Doctors Hospital and Medical Center,2020-06-21,0,0,0,0,0,0,79,0,1625,1607,34,1573,0.02,0.98,
Lucena United Doctors Hospital and Medical Center,2020-06-22,114,112,0,112,0,0,1162,29,1739,1719,34,1685,0.02,0.98,
Lucena United Doctors Hospital and Medical Center,2020-06-23,110,110,0,110,0,0,1048,0,1849,1829,34,1795,0.02,0.98,
Lucena United Doctors Hospital and Medical Center,2020-06-24,91,80,1,79,0,11,953,0,1940,1909,35,1874,0.02,0.98,
Lucena United Doctors Hospital and Medical Center,2020-06-25,113,107,0,107,0,1,836,0,2053,2016,35,1981,0.02,0.98,
Lucena United Doctors Hospital and Medical Center,2020-06-26,106,105,0,105,0,1,726,0,2159,2121,35,2086,0.02,0.98,
Lucena United Doctors Hospital and Medical Center,2020-06-27,58,57,0,57,0,1,664,0,2217,2178,35,2143,0.02,0.98,
Lung Center of the Philippines (LCP),2020-04-03,82,82,10,72,,,4649,,250,250,32,218,0.13,0.87,
Lung Center of the Philippines (LCP),2020-04-04,0,0,0,0,,,4649,,250,250,32,218,0.13,0.87,
Lung Center of the Philippines (LCP),2020-04-05,0,0,0,0,,,4649,,250,250,32,218,0.13,0.87,
Lung Center of the Philippines (LCP),2020-04-06,90,90,18,72,,,4512,,340,340,50,290,0.15,0.85,
Lung Center of the Philippines (LCP),2020-04-07,83,83,5,78,,,4424,,423,423,55,368,0.13,0.87,
Lung Center of the Philippines (LCP),2020-04-08,148,148,7,141,,,4263,,571,571,62,509,0.11,0.89,
Lung Center of the Philippines (LCP),2020-04-09,89,89,3,86,,,4163,,660,660,65,595,0.1,0.9,
Lung Center of the Philippines (LCP),2020-04-10,93,93,3,90,,,4037,,753,753,68,685,0.09,0.91,
Lung Center of the Philippines (LCP),2020-04-11,0,0,0,0,,,4037,,753,753,68,685,0.09,0.91,
Lung Center of the Philippines (LCP),2020-04-12,111,93,5,88,,,3930,,864,846,73,773,0.09,0.91,
Lung Center of the Philippines (LCP),2020-04-13,109,109,11,98,,,3750,,973,955,84,871,0.09,0.91,
Lung Center of the Philippines (LCP),2020-04-14,214,214,17,197,,,3500,,1187,1169,101,1068,0.09,0.91,
Lung Center of the Philippines (LCP),2020-04-15,186,186,10,176,,,3300,,1373,1355,111,1244,0.08,0.92,
Lung Center of the Philippines (LCP),2020-04-16,279,279,6,273,,,3000,,1652,1634,117,1517,0.07,0.93,
Lung Center of the Philippines (LCP),2020-04-17,459,446,13,433,,,2400,,2111,2080,130,1950,0.06,0.94,
Lung Center of the Philippines (LCP),2020-04-18,181,181,1,180,,,2220,,2292,2261,131,2130,0.06,0.94,
Lung Center of the Philippines (LCP),2020-04-19,88,88,3,85,,,2100,,2380,2349,134,2215,0.06,0.94,
Lung Center of the Philippines (LCP),2020-04-20,186,186,4,182,,,1900,,2566,2535,138,2397,0.05,0.95,
Lung Center of the Philippines (LCP),2020-04-21,93,93,6,87,,,1800,,2659,2628,144,2484,0.05,0.95,
Lung Center of the Philippines (LCP),2020-04-22,458,458,18,440,,,1300,,3117,3086,162,2924,0.05,0.95,
Lung Center of the Philippines (LCP),2020-04-23,341,341,41,300,,,4300,,3458,3427,203,3224,0.06,0.94,
Lung Center of the Philippines (LCP),2020-04-24,759,759,36,723,,,3400,,4217,4186,239,3947,0.06,0.94,
Lung Center of the Philippines (LCP),2020-04-25,199,199,14,185,,,3150,,4416,4385,253,4132,0.06,0.94,
Lung Center of the Philippines (LCP),2020-04-26,254,254,11,243,,,2850,,4670,4639,264,4375,0.06,0.94,
Lung Center of the Philippines (LCP),2020-04-27,272,272,12,260,,,2550,,4942,4911,276,4635,0.06,0.94,
Lung Center of the Philippines (LCP),2020-04-28,237,237,19,218,,,2250,,5179,5148,295,4853,0.06,0.94,
Lung Center of the Philippines (LCP),2020-04-29,833,833,60,773,,,1550,,6012,5981,355,5626,0.06,0.94,
Lung Center of the Philippines (LCP),2020-04-30,367,367,14,353,,,1850,,6379,6348,369,5979,0.06,0.94,
Lung Center of the Philippines (LCP),2020-05-01,278,278,27,251,,,1550,,6657,6626,396,6230,0.06,0.94,
Lung Center of the Philippines (LCP),2020-05-02,371,371,21,350,,,1150,,7028,6997,417,6580,0.06,0.94,
Lung Center of the Philippines (LCP),2020-05-03,556,556,13,543,,,600,,7584,7553,430,7123,0.06,0.94,
Lung Center of the Philippines (LCP),2020-05-04,557,557,11,546,,,40,,8141,8110,441,7669,0.05,0.95,
Lung Center of the Philippines (LCP),2020-05-05,279,279,10,269,,,40,,8420,8389,451,7938,0.05,0.95,
Lung Center of the Philippines (LCP),2020-05-06,91,91,10,81,,,40,,8511,8480,461,8019,0.05,0.95,
Lung Center of the Philippines (LCP),2020-05-07,358,358,22,336,,,5400,,8869,8838,483,8355,0.05,0.95,
Lung Center of the Philippines (LCP),2020-05-08,462,462,12,450,,,5000,,9331,9300,495,8805,0.05,0.95,
Lung Center of the Philippines (LCP),2020-05-09,834,834,27,807,,,4100,,10165,10134,522,9612,0.05,0.95,
Lung Center of the Philippines (LCP),2020-05-10,930,930,29,901,,,3100,,11095,11064,551,10513,0.05,0.95,
Lung Center of the Philippines (LCP),2020-05-11,372,372,28,344,,,2500,,11467,11436,579,10857,0.05,0.95,
Lung Center of the Philippines (LCP),2020-05-12,0,0,0,0,,,2500,,11467,11436,579,10857,0.05,0.95,
Lung Center of the Philippines (LCP),2020-05-13,0,0,0,0,,,2500,,11467,11436,579,10857,0.05,0.95,
Lung Center of the Philippines (LCP),2020-05-14,306,306,7,299,,,2200,,11773,11742,586,11156,0.05,0.95,
Lung Center of the Philippines (LCP),2020-05-15,215,215,1,214,,,2200,,11988,11957,587,11370,0.05,0.95,
Lung Center of the Philippines (LCP),2020-05-16,456,456,4,452,0,0,2000,,12444,12413,591,11822,0.05,0.95,
Lung Center of the Philippines (LCP),2020-05-17,372,358,1,357,0,0,597,,12816,12771,592,12179,0.05,0.95,
Lung Center of the Philippines (LCP),2020-05-18,651,651,74,577,0,0,1100,,13467,13422,666,12756,0.05,0.95,
Lung Center of the Philippines (LCP),2020-05-19,558,558,16,542,0,0,800,1400,14025,13980,682,13298,0.05,0.95,
Lung Center of the Philippines (LCP),2020-05-20,652,652,17,635,0,0,5000,700,14677,14632,699,13933,0.05,0.95,
Lung Center of the Philippines (LCP),2020-05-21,277,277,18,259,0,0,4500,393,14954,14909,717,14192,0.05,0.95,
Lung Center of the Philippines (LCP),2020-05-22,350,350,5,345,0,0,4100,93,15304,15259,722,14537,0.05,0.95,
Lung Center of the Philippines (LCP),2020-05-23,91,91,0,91,0,0,4000,0,15395,15350,722,14628,0.05,0.95,
Lung Center of the Philippines (LCP),2020-05-24,62,62,1,61,0,0,3950,0,15457,15412,723,14689,0.05,0.95,
Lung Center of the Philippines (LCP),2020-05-25,22,22,1,21,0,0,3900,2,15479,15434,724,14710,0.05,0.95,
Lung Center of the Philippines (LCP),2020-05-26,75,75,0,75,0,0,3825,0,15554,15509,724,14785,0.05,0.95,
Lung Center of the Philippines (LCP),2020-05-27,92,90,2,88,0,2,3725,0,15646,15599,726,14873,0.05,0.95,
Lung Center of the Philippines (LCP),2020-05-28,93,93,1,92,0,0,3650,0,15739,15692,727,14965,0.05,0.95,
Lung Center of the Philippines (LCP),2020-05-29,91,91,4,87,0,0,3560,0,15830,15783,731,15052,0.05,0.95,
Lung Center of the Philippines (LCP),2020-05-30,93,93,0,93,0,0,3460,0,15923,15876,731,15145,0.05,0.95,
Lung Center of the Philippines (LCP),2020-05-31,92,92,4,88,0,0,3360,0,16015,15968,735,15233,0.05,0.95,
Lung Center of the Philippines (LCP),2020-06-01,91,90,1,89,0,1,3270,0,16106,16058,736,15322,0.05,0.95,
Lung Center of the Philippines (LCP),2020-06-02,184,184,2,182,0,1,3070,0,16290,16242,738,15504,0.05,0.95,
Lung Center of the Philippines (LCP),2020-06-03,184,184,3,181,0,0,2870,0,16474,16426,741,15685,0.05,0.95,
Lung Center of the Philippines (LCP),2020-06-04,93,92,1,91,0,1,8780,0,16567,16518,742,15776,0.04,0.96,
Lung Center of the Philippines (LCP),2020-06-05,185,185,0,185,0,0,8600,0,16752,16703,742,15961,0.04,0.96,
Lung Center of the Philippines (LCP),2020-06-06,183,183,5,178,0,0,8420,0,16935,16886,747,16139,0.04,0.96,
Lung Center of the Philippines (LCP),2020-06-07,93,93,2,91,0,0,8330,0,17028,16979,749,16230,0.04,0.96,
Lung Center of the Philippines (LCP),2020-06-08,91,90,0,90,0,1,8240,0,17119,17069,749,16320,0.04,0.96,
Lung Center of the Philippines (LCP),2020-06-09,165,165,3,162,0,0,8075,0,17284,17234,752,16482,0.04,0.96,
Lung Center of the Philippines (LCP),2020-06-10,185,185,3,182,0,0,7890,0,17469,17419,755,16664,0.04,0.96,
Lung Center of the Philippines (LCP),2020-06-11,185,184,4,180,0,1,7705,0,17654,17603,759,16844,0.04,0.96,
Lung Center of the Philippines (LCP),2020-06-12,184,184,1,183,0,0,7630,0,17838,17787,760,17027,0.04,0.96,
Lung Center of the Philippines (LCP),2020-06-13,93,93,7,86,0,0,7550,0,17931,17880,767,17113,0.04,0.96,
Lung Center of the Philippines (LCP),2020-06-14,157,157,7,150,0,0,7400,0,18088,18037,774,17263,0.04,0.96,
Lung Center of the Philippines (LCP),2020-06-15,93,93,1,92,0,0,7310,0,18181,18130,775,17355,0.04,0.96,
Lung Center of the Philippines (LCP),2020-06-16,186,186,4,182,0,0,7100,0,18367,18316,779,17537,0.04,0.96,
Lung Center of the Philippines (LCP),2020-06-17,180,180,3,177,0,0,6920,0,18547,18496,782,17714,0.04,0.96,
Lung Center of the Philippines (LCP),2020-06-18,279,279,11,268,0,0,6640,0,18826,18775,793,17982,0.04,0.96,
Lung Center of the Philippines (LCP),2020-06-19,275,275,10,265,0,0,6365,0,19101,19050,803,18247,0.04,0.96,
Lung Center of the Philippines (LCP),2020-06-20,174,174,10,164,0,0,6192,0,19275,19224,813,18411,0.04,0.96,
Lung Center of the Philippines (LCP),2020-06-21,86,86,3,83,0,0,6106,0,19361,19310,816,18494,0.04,0.96,
Lung Center of the Philippines (LCP),2020-06-22,185,185,12,173,0,0,5921,0,19546,19495,828,18667,0.04,0.96,
Lung Center of the Philippines (LCP),2020-06-23,183,183,12,171,0,0,5738,0,19729,19678,840,18838,0.04,0.96,
Lung Center of the Philippines (LCP),2020-06-24,162,162,7,155,0,0,5576,0,19891,19840,847,18993,0.04,0.96,
Lung Center of the Philippines (LCP),2020-06-25,258,258,40,218,0,0,5318,0,20149,20098,887,19211,0.04,0.96,
Lung Center of the Philippines (LCP),2020-06-26,238,238,14,224,0,0,5018,0,20387,20336,901,19435,0.04,0.96,
Lung Center of the Philippines (LCP),2020-06-27,135,128,15,113,0,7,4920,0,20522,20464,916,19548,0.04,0.96,
Lung Center of the Philippines GeneXpert Laboratory,2020-05-06,17,16,3,13,,,1003,,17,16,3,13,0.19,0.81,
Lung Center of the Philippines GeneXpert Laboratory,2020-05-07,29,28,5,23,,,974,,46,44,8,36,0.18,0.82,
Lung Center of the Philippines GeneXpert Laboratory,2020-05-08,39,39,6,33,,,935,,85,83,14,69,0.17,0.83,
Lung Center of the Philippines GeneXpert Laboratory,2020-05-09,0,0,0,0,,,935,,85,83,14,69,0.17,0.83,
Lung Center of the Philippines GeneXpert Laboratory,2020-05-10,69,69,5,64,,,866,,154,152,19,133,0.13,0.88,
Lung Center of the Philippines GeneXpert Laboratory,2020-05-11,49,49,15,34,,,817,,203,201,34,167,0.17,0.83,
Lung Center of the Philippines GeneXpert Laboratory,2020-05-12,42,42,13,29,,,775,,245,243,47,196,0.19,0.81,
Lung Center of the Philippines GeneXpert Laboratory,2020-05-13,67,67,17,50,,,708,,312,310,64,246,0.21,0.79,
Lung Center of the Philippines GeneXpert Laboratory,2020-05-14,72,72,10,62,,,636,,384,382,74,308,0.19,0.81,
Lung Center of the Philippines GeneXpert Laboratory,2020-05-15,115,115,10,105,,,641,,499,497,84,413,0.17,0.83,
Lung Center of the Philippines GeneXpert Laboratory,2020-05-16,0,0,0,0,0,0,641,,499,497,84,413,0.17,0.83,
Lung Center of the Philippines GeneXpert Laboratory,2020-05-17,42,42,13,29,0,0,599,,541,539,97,442,0.18,0.82,
Lung Center of the Philippines GeneXpert Laboratory,2020-05-18,70,69,17,52,1,0,529,,611,608,114,494,0.19,0.81,
Lung Center of the Philippines GeneXpert Laboratory,2020-05-19,57,56,8,48,0,1,469,1,668,664,122,542,0.18,0.82,
Lung Center of the Philippines GeneXpert Laboratory,2020-05-20,119,115,9,106,1,3,351,1,787,779,131,648,0.17,0.83,
Lung Center of the Philippines GeneXpert Laboratory,2020-05-21,75,73,9,64,0,2,278,0,862,852,140,712,0.16,0.84,
Lung Center of the Philippines GeneXpert Laboratory,2020-05-22,101,100,11,89,0,1,1917,1,963,952,151,801,0.16,0.84,
Lung Center of the Philippines GeneXpert Laboratory,2020-05-23,0,0,0,0,0,0,1917,1,963,952,151,801,0.16,0.84,
Lung Center of the Philippines GeneXpert Laboratory,2020-05-24,25,24,10,14,0,1,1892,0,988,976,161,815,0.16,0.84,
Lung Center of the Philippines GeneXpert Laboratory,2020-05-25,0,0,0,0,0,0,1322,0,988,976,161,815,0.16,0.84,
Lung Center of the Philippines GeneXpert Laboratory,2020-05-26,73,70,11,59,1,2,1249,1,1061,1046,172,874,0.16,0.84,
Lung Center of the Philippines GeneXpert Laboratory,2020-05-27,41,40,4,36,1,0,1208,0,1102,1086,176,910,0.16,0.84,
Lung Center of the Philippines GeneXpert Laboratory,2020-05-28,53,52,5,47,0,1,1155,0,1155,1138,181,957,0.16,0.84,
Lung Center of the Philippines GeneXpert Laboratory,2020-05-29,55,55,6,49,0,0,2270,0,1210,1193,187,1006,0.16,0.84,
Lung Center of the Philippines GeneXpert Laboratory,2020-05-30,0,0,0,0,0,0,2270,0,1210,1193,187,1006,0.16,0.84,
Lung Center of the Philippines GeneXpert Laboratory,2020-05-31,18,18,1,17,0,0,2252,0,1228,1211,188,1023,0.16,0.84,
Lung Center of the Philippines GeneXpert Laboratory,2020-06-01,27,26,4,22,0,1,2225,0,1255,1237,192,1045,0.16,0.84,
Lung Center of the Philippines GeneXpert Laboratory,2020-06-02,20,20,2,18,0,0,2205,0,1275,1257,194,1063,0.15,0.85,
Lung Center of the Philippines GeneXpert Laboratory,2020-06-03,32,32,6,26,0,0,2173,0,1307,1289,200,1089,0.16,0.84,
Lung Center of the Philippines GeneXpert Laboratory,2020-06-04,14,14,1,13,0,0,2159,0,1321,1303,201,1102,0.15,0.85,
Lung Center of the Philippines GeneXpert Laboratory,2020-06-05,20,20,0,20,0,0,2139,0,1341,1323,201,1122,0.15,0.85,
Lung Center of the Philippines GeneXpert Laboratory,2020-06-06,0,0,0,0,0,0,2139,0,1341,1323,201,1122,0.15,0.85,
Lung Center of the Philippines GeneXpert Laboratory,2020-06-07,12,12,5,7,0,0,2127,0,1353,1335,206,1129,0.15,0.85,
Lung Center of the Philippines GeneXpert Laboratory,2020-06-08,28,26,4,22,1,1,2099,0,1381,1361,210,1151,0.15,0.85,
Lung Center of the Philippines GeneXpert Laboratory,2020-06-09,11,11,2,9,0,0,2088,0,1392,1372,212,1160,0.15,0.85,
Lung Center of the Philippines GeneXpert Laboratory,2020-06-10,18,17,1,16,0,1,2070,0,1410,1389,213,1176,0.15,0.85,
Lung Center of the Philippines GeneXpert Laboratory,2020-06-11,21,18,2,16,2,1,2049,0,1431,1407,215,1192,0.15,0.85,
Lung Center of the Philippines GeneXpert Laboratory,2020-06-12,2,2,0,2,0,0,2047,0,1433,1409,215,1194,0.15,0.85,
Lung Center of the Philippines GeneXpert Laboratory,2020-06-13,15,14,1,13,1,0,2032,0,1448,1423,216,1207,0.15,0.85,
Lung Center of the Philippines GeneXpert Laboratory,2020-06-14,0,0,0,0,0,0,2032,0,1448,1423,216,1207,0.15,0.85,
Lung Center of the Philippines GeneXpert Laboratory,2020-06-15,18,18,9,9,0,0,2014,0,1466,1441,225,1216,0.16,0.84,
Lung Center of the Philippines GeneXpert Laboratory,2020-06-16,19,19,2,17,1,0,1994,0,1485,1460,227,1233,0.16,0.84,
Lung Center of the Philippines GeneXpert Laboratory,2020-06-17,58,57,0,57,0,1,1936,0,1543,1517,227,1290,0.15,0.85,
Lung Center of the Philippines GeneXpert Laboratory,2020-06-18,13,13,0,13,0,0,1923,0,1556,1530,227,1303,0.15,0.85,
Lung Center of the Philippines GeneXpert Laboratory,2020-06-19,24,24,0,24,0,0,1899,0,1580,1554,227,1327,0.15,0.85,
Lung Center of the Philippines GeneXpert Laboratory,2020-06-20,0,0,0,0,0,0,1899,0,1580,1554,227,1327,0.15,0.85,
Lung Center of the Philippines GeneXpert Laboratory,2020-06-21,14,14,3,11,0,0,1885,0,1594,1568,230,1338,0.15,0.85,
Lung Center of the Philippines GeneXpert Laboratory,2020-06-22,13,11,2,9,2,0,1872,0,1607,1579,232,1347,0.15,0.85,
Lung Center of the Philippines GeneXpert Laboratory,2020-06-23,12,12,1,11,0,0,1860,0,1619,1591,233,1358,0.15,0.85,
Lung Center of the Philippines GeneXpert Laboratory,2020-06-24,14,14,2,12,0,0,1846,0,1633,1605,235,1370,0.15,0.85,
Lung Center of the Philippines GeneXpert Laboratory,2020-06-25,18,18,1,17,0,0,1828,0,1651,1623,236,1387,0.15,0.85,
Lung Center of the Philippines GeneXpert Laboratory,2020-06-26,27,27,5,22,0,0,1801,0,1678,1650,241,1409,0.15,0.85,
Lung Center of the Philippines GeneXpert Laboratory,2020-06-27,0,0,0,0,0,0,1801,0,1678,1650,241,1409,0.15,0.85,
Makati Medical Center (MMC),2020-04-14,23,23,0,23,,,1901,,23,23,0,23,0.0,1.0,
Makati Medical Center (MMC),2020-04-15,127,127,2,125,,,1797,,150,150,2,148,0.01,0.99,
Makati Medical Center (MMC),2020-04-16,31,31,4,27,,,1762,,181,181,6,175,0.03,0.97,
Makati Medical Center (MMC),2020-04-17,121,121,13,108,,,1617,,302,302,19,283,0.06,0.94,
Makati Medical Center (MMC),2020-04-18,266,266,12,254,,,1324,,568,568,31,537,0.05,0.95,
Makati Medical Center (MMC),2020-04-19,0,0,0,0,,,1324,,568,568,31,537,0.05,0.95,
Makati Medical Center (MMC),2020-04-20,108,108,15,93,,,1138,,676,676,46,630,0.07,0.93,
Makati Medical Center (MMC),2020-04-21,160,160,27,133,,,964,,836,836,73,763,0.09,0.91,
Makati Medical Center (MMC),2020-04-22,8,8,1,7,,,888,,844,844,74,770,0.09,0.91,
Makati Medical Center (MMC),2020-04-23,107,107,8,99,,,765,,951,951,82,869,0.09,0.91,
Makati Medical Center (MMC),2020-04-24,103,103,4,99,,,650,,1054,1054,86,968,0.08,0.92,
Makati Medical Center (MMC),2020-04-25,80,80,5,75,,,572,,1134,1134,91,1043,0.08,0.92,
Makati Medical Center (MMC),2020-04-26,123,123,9,114,,,398,,1257,1257,100,1157,0.08,0.92,
Makati Medical Center (MMC),2020-04-27,56,56,3,53,,,393,,1313,1313,103,1210,0.08,0.92,
Makati Medical Center (MMC),2020-04-28,186,186,13,173,,,185,,1499,1499,116,1383,0.08,0.92,
Makati Medical Center (MMC),2020-04-29,64,63,1,62,,,56,,1563,1562,117,1445,0.07,0.93,
Makati Medical Center (MMC),2020-04-30,40,40,1,39,,,11,,1603,1602,118,1484,0.07,0.93,
Makati Medical Center (MMC),2020-05-01,87,73,5,68,,,9912,,1690,1675,123,1552,0.07,0.93,
Makati Medical Center (MMC),2020-05-02,56,48,2,46,,,9846,,1746,1723,125,1598,0.07,0.93,
Makati Medical Center (MMC),2020-05-03,31,25,2,23,,,9812,,1777,1748,127,1621,0.07,0.93,
Makati Medical Center (MMC),2020-05-04,63,52,1,51,,,9735,,1840,1800,128,1672,0.07,0.93,
Makati Medical Center (MMC),2020-05-05,71,68,5,63,,,9666,,1911,1868,133,1735,0.07,0.93,
Makati Medical Center (MMC),2020-05-06,87,68,5,63,,,9566,,1998,1936,138,1798,0.07,0.93,
Makati Medical Center (MMC),2020-05-07,98,85,0,85,,,9456,,2096,2021,138,1883,0.07,0.93,
Makati Medical Center (MMC),2020-05-08,55,47,0,47,,,9393,,2151,2068,138,1930,0.07,0.93,
Makati Medical Center (MMC),2020-05-09,86,83,2,81,,,9304,,2237,2151,140,2011,0.07,0.93,
Makati Medical Center (MMC),2020-05-10,49,39,2,37,,,9253,,2286,2190,142,2048,0.06,0.94,
Makati Medical Center (MMC),2020-05-11,82,67,8,59,,,9174,,2368,2257,150,2107,0.07,0.93,
Makati Medical Center (MMC),2020-05-12,73,63,4,59,,,9100,,2441,2320,154,2166,0.07,0.93,
Makati Medical Center (MMC),2020-05-13,86,64,6,58,,,9020,,2527,2384,160,2224,0.07,0.93,
Makati Medical Center (MMC),2020-05-14,149,141,7,134,,,8871,,2676,2525,167,2358,0.07,0.93,
Makati Medical Center (MMC),2020-05-15,119,113,6,107,,,8746,,2795,2638,173,2465,0.07,0.93,
Makati Medical Center (MMC),2020-05-16,108,102,3,99,0,0,8632,,2903,2740,176,2564,0.06,0.94,
Makati Medical Center (MMC),2020-05-17,73,67,0,67,0,0,8559,,2976,2807,176,2631,0.06,0.94,
Makati Medical Center (MMC),2020-05-18,76,73,8,65,0,0,8477,,3052,2880,184,2696,0.06,0.94,
Makati Medical Center (MMC),2020-05-19,142,132,13,119,0,0,8205,0,3194,3012,197,2815,0.07,0.93,
Makati Medical Center (MMC),2020-05-20,218,142,7,135,0,0,7981,0,3412,3154,204,2950,0.06,0.94,
Makati Medical Center (MMC),2020-05-21,225,206,4,202,0,0,1764,0,3637,3360,208,3152,0.06,0.94,
Makati Medical Center (MMC),2020-05-22,225,207,3,204,0,0,1764,0,3862,3567,211,3356,0.06,0.94,
Makati Medical Center (MMC),2020-05-23,169,162,14,148,0,0,1428,0,4031,3729,225,3504,0.06,0.94,
Makati Medical Center (MMC),2020-05-24,55,50,4,46,0,0,1428,0,4086,3779,229,3550,0.06,0.94,
Makati Medical Center (MMC),2020-05-25,92,88,6,82,0,0,6783,0,4178,3867,235,3632,0.06,0.94,
Makati Medical Center (MMC),2020-05-26,214,210,9,201,0,0,882,0,4392,4077,244,3833,0.06,0.94,
Makati Medical Center (MMC),2020-05-27,213,206,12,194,0,0,630,0,4605,4283,256,4027,0.06,0.94,
Makati Medical Center (MMC),2020-05-28,184,173,4,169,0,0,420,0,4789,4456,260,4196,0.06,0.94,
Makati Medical Center (MMC),2020-05-29,235,231,12,219,0,0,420,0,5024,4687,272,4415,0.06,0.94,
Makati Medical Center (MMC),2020-05-30,176,136,12,124,0,0,2310,0,5200,4823,284,4539,0.06,0.94,
Makati Medical Center (MMC),2020-05-31,0,0,0,0,0,0,2310,0,5200,4823,284,4539,0.06,0.94,
Makati Medical Center (MMC),2020-06-01,107,101,5,96,0,0,0,0,5307,4924,289,4635,0.06,0.94,
Makati Medical Center (MMC),2020-06-02,193,181,10,171,0,0,1701,0,5500,5105,299,4806,0.06,0.94,
Makati Medical Center (MMC),2020-06-03,376,380,13,367,0,0,1281,0,5876,5485,312,5173,0.06,0.94,For Review
Makati Medical Center (MMC),2020-06-04,377,370,9,361,0,0,7512,300,6253,5855,321,5534,0.05,0.95,
Makati Medical Center (MMC),2020-06-05,391,389,19,370,0,0,6573,0,6644,6244,340,5904,0.05,0.95,
Makati Medical Center (MMC),2020-06-06,528,520,19,501,0,0,5628,0,7172,6764,359,6405,0.05,0.95,
Makati Medical Center (MMC),2020-06-07,0,0,0,0,0,0,5628,200,7172,6764,359,6405,0.05,0.95,
Makati Medical Center (MMC),2020-06-08,383,375,16,359,0,0,5481,0,7555,7139,375,6764,0.05,0.95,
Makati Medical Center (MMC),2020-06-09,462,442,19,423,0,0,4977,0,8017,7581,394,7187,0.05,0.95,
Makati Medical Center (MMC),2020-06-10,327,303,18,285,0,0,4557,0,8344,7884,412,7472,0.05,0.95,
Makati Medical Center (MMC),2020-06-11,307,301,24,277,0,0,0,0,8651,8185,436,7749,0.05,0.95,
Makati Medical Center (MMC),2020-06-12,438,435,37,398,0,0,3780,0,9089,8620,473,8147,0.05,0.95,
Makati Medical Center (MMC),2020-06-13,387,373,18,355,0,0,3381,0,9476,8993,491,8502,0.05,0.95,
Makati Medical Center (MMC),2020-06-14,217,208,4,204,0,0,3381,0,9693,9201,495,8706,0.05,0.95,
Makati Medical Center (MMC),2020-06-15,144,136,2,134,0,0,0,0,9837,9337,497,8840,0.05,0.95,
Makati Medical Center (MMC),2020-06-16,,,,,,,,,9837,9337,497,8840,0.05,0.95,
Makati Medical Center (MMC),2020-06-17,298,291,16,275,0,0,2121,0,10135,9628,513,9115,0.05,0.95,
Makati Medical Center (MMC),2020-06-18,325,314,18,296,0,0,0,0,10460,9942,531,9411,0.05,0.95,
Makati Medical Center (MMC),2020-06-19,,,,,,,,,10460,9942,531,9411,0.05,0.95,
Makati Medical Center (MMC),2020-06-20,255,249,17,232,0,0,1155,0,10715,10191,548,9643,0.05,0.95,
Makati Medical Center (MMC),2020-06-21,273,266,11,255,0,0,1155,0,10988,10457,559,9898,0.05,0.95,
Makati Medical Center (MMC),2020-06-22,86,86,2,84,0,0,1134,0,11074,10543,561,9982,0.05,0.95,
Makati Medical Center (MMC),2020-06-23,319,289,13,276,0,0,6783,0,11393,10832,574,10258,0.05,0.95,
Makati Medical Center (MMC),2020-06-24,301,287,6,281,0,0,6482,0,11694,11119,580,10539,0.05,0.95,
Makati Medical Center (MMC),2020-06-25,289,271,14,257,0,0,6384,0,11983,11390,594,10796,0.05,0.95,
Makati Medical Center (MMC),2020-06-26,288,247,15,232,0,0,6111,0,12271,11637,609,11028,0.05,0.95,
Makati Medical Center (MMC),2020-06-27,242,224,25,199,0,0,5544,0,12513,11861,634,11227,0.05,0.95,
Mariano Marcos Memorial Hospital (RT PCR),2020-06-15,0,0,0,0,0,0,30,0,0,0,0,0,,,
Mariano Marcos Memorial Hospital (RT PCR),2020-06-16,0,0,0,0,0,0,30,0,0,0,0,0,,,
Mariano Marcos Memorial Hospital (RT PCR),2020-06-17,0,0,0,0,0,0,384,0,0,0,0,0,,,
Mariano Marcos Memorial Hospital (RT PCR),2020-06-18,0,0,0,0,0,0,384,0,0,0,0,0,,,
Mariano Marcos Memorial Hospital (RT PCR),2020-06-19,32,32,0,32,0,0,324,0,32,32,0,32,0.0,1.0,
Mariano Marcos Memorial Hospital (RT PCR),2020-06-20,26,26,0,26,0,0,298,0,58,58,0,58,0.0,1.0,
Mariano Marcos Memorial Hospital (RT PCR),2020-06-21,0,0,0,0,0,0,298,0,58,58,0,58,0.0,1.0,
Mariano Marcos Memorial Hospital (RT PCR),2020-06-22,0,0,0,0,0,0,298,0,58,58,0,58,0.0,1.0,
Mariano Marcos Memorial Hospital (RT PCR),2020-06-23,42,42,0,42,0,0,280,0,100,100,0,100,0.0,1.0,
Mariano Marcos Memorial Hospital (RT PCR),2020-06-24,0,0,0,0,0,0,280,0,100,100,0,100,0.0,1.0,
Mariano Marcos Memorial Hospital (RT PCR),2020-06-25,54,54,0,54,0,0,220,0,154,154,0,154,0.0,1.0,
Mariano Marcos Memorial Hospital (RT PCR),2020-06-26,23,23,0,23,0,0,197,0,177,177,0,177,0.0,1.0,
Mariano Marcos Memorial Hospital (RT PCR),2020-06-27,0,0,0,0,0,0,197,0,177,177,0,177,0.0,1.0,
Mariano Marcos Memorial Hospital GeneXpert Laboratory,2020-06-03,9,9,0,9,0,0,1190,0,9,9,0,9,0.0,1.0,
Mariano Marcos Memorial Hospital GeneXpert Laboratory,2020-06-04,0,0,0,0,0,0,1190,0,9,9,0,9,0.0,1.0,
Mariano Marcos Memorial Hospital GeneXpert Laboratory,2020-06-05,14,14,0,14,0,0,1176,0,23,23,0,23,0.0,1.0,
Mariano Marcos Memorial Hospital GeneXpert Laboratory,2020-06-06,0,0,0,0,0,0,1176,0,23,23,0,23,0.0,1.0,
Mariano Marcos Memorial Hospital GeneXpert Laboratory,2020-06-07,0,0,0,0,0,0,1176,0,23,23,0,23,0.0,1.0,
Mariano Marcos Memorial Hospital GeneXpert Laboratory,2020-06-08,12,12,0,12,0,0,1164,0,35,35,0,35,0.0,1.0,
Mariano Marcos Memorial Hospital GeneXpert Laboratory,2020-06-09,8,8,1,7,0,0,1156,0,43,43,1,42,0.02,0.98,
Mariano Marcos Memorial Hospital GeneXpert Laboratory,2020-06-10,6,6,0,6,0,0,1150,0,49,49,1,48,0.02,0.98,
Mariano Marcos Memorial Hospital GeneXpert Laboratory,2020-06-11,7,7,0,7,0,0,1143,0,56,56,1,55,0.02,0.98,
Mariano Marcos Memorial Hospital GeneXpert Laboratory,2020-06-12,24,24,0,24,0,0,1119,0,80,80,1,79,0.01,0.99,
Mariano Marcos Memorial Hospital GeneXpert Laboratory,2020-06-13,0,0,0,0,0,0,1119,0,80,80,1,79,0.01,0.99,
Mariano Marcos Memorial Hospital GeneXpert Laboratory,2020-06-14,0,0,0,0,0,0,1119,0,80,80,1,79,0.01,0.99,
Mariano Marcos Memorial Hospital GeneXpert Laboratory,2020-06-15,10,10,0,10,0,0,1109,0,90,90,1,89,0.01,0.99,
Mariano Marcos Memorial Hospital GeneXpert Laboratory,2020-06-16,24,24,1,23,0,0,1095,0,114,114,2,112,0.02,0.98,
Mariano Marcos Memorial Hospital GeneXpert Laboratory,2020-06-17,11,11,1,10,0,0,1074,0,125,125,3,122,0.02,0.98,
Mariano Marcos Memorial Hospital GeneXpert Laboratory,2020-06-18,1,1,0,1,0,0,1073,0,126,126,3,123,0.02,0.98,
Mariano Marcos Memorial Hospital GeneXpert Laboratory,2020-06-19,5,5,0,5,0,0,1068,0,131,131,3,128,0.02,0.98,
Mariano Marcos Memorial Hospital GeneXpert Laboratory,2020-06-20,24,24,1,23,0,0,1044,0,155,155,4,151,0.03,0.97,
Mariano Marcos Memorial Hospital GeneXpert Laboratory,2020-06-21,0,0,0,0,0,0,1044,0,155,155,4,151,0.03,0.97,
Mariano Marcos Memorial Hospital GeneXpert Laboratory,2020-06-22,8,8,0,8,0,0,1036,0,163,163,4,159,0.02,0.98,
Mariano Marcos Memorial Hospital GeneXpert Laboratory,2020-06-23,4,4,0,4,0,0,1032,0,167,167,4,163,0.02,0.98,
Mariano Marcos Memorial Hospital GeneXpert Laboratory,2020-06-24,13,13,0,13,0,0,1019,0,180,180,4,176,0.02,0.98,
Mariano Marcos Memorial Hospital GeneXpert Laboratory,2020-06-25,5,5,0,5,0,0,1014,0,185,185,4,181,0.02,0.98,
Mariano Marcos Memorial Hospital GeneXpert Laboratory,2020-06-26,0,0,0,0,0,0,1014,0,185,185,4,181,0.02,0.98,
Mariano Marcos Memorial Hospital GeneXpert Laboratory,2020-06-27,2,2,0,2,0,0,1012,0,187,187,4,183,0.02,0.98,
Marikina Molecular Diagnostics Laboratory (MMDL),2020-05-07,64,61,3,58,,,308,,64,61,3,58,0.05,0.95,
Marikina Molecular Diagnostics Laboratory (MMDL),2020-05-08,32,25,1,24,,,308,,96,86,4,82,0.05,0.95,
Marikina Molecular Diagnostics Laboratory (MMDL),2020-05-09,64,63,4,59,,,308,,160,149,8,141,0.05,0.95,
Marikina Molecular Diagnostics Laboratory (MMDL),2020-05-10,31,30,1,29,,,308,,191,179,9,170,0.05,0.95,
Marikina Molecular Diagnostics Laboratory (MMDL),2020-05-11,112,102,12,90,,,,,303,281,21,260,0.07,0.93,
Marikina Molecular Diagnostics Laboratory (MMDL),2020-05-12,40,40,13,27,,,,,343,321,34,287,0.11,0.89,
Marikina Molecular Diagnostics Laboratory (MMDL),2020-05-13,96,87,4,83,,,357,,439,408,38,370,0.09,0.91,
Marikina Molecular Diagnostics Laboratory (MMDL),2020-05-14,0,0,0,0,,,357,,439,408,38,370,0.09,0.91,
Marikina Molecular Diagnostics Laboratory (MMDL),2020-05-15,176,167,2,165,,,427,,615,575,40,535,0.07,0.93,
Marikina Molecular Diagnostics Laboratory (MMDL),2020-05-16,48,36,0,36,0,0,1920,,663,611,40,571,0.07,0.93,
Marikina Molecular Diagnostics Laboratory (MMDL),2020-05-17,0,0,0,0,0,0,,,663,611,40,571,0.07,0.93,
Marikina Molecular Diagnostics Laboratory (MMDL),2020-05-18,109,105,0,105,0,0,3717,,772,716,40,676,0.06,0.94,
Marikina Molecular Diagnostics Laboratory (MMDL),2020-05-19,161,161,5,156,0,0,60,401,933,877,45,832,0.05,0.95,
Marikina Molecular Diagnostics Laboratory (MMDL),2020-05-20,231,221,18,203,10,0,45,325,1164,1098,63,1035,0.06,0.94,
Marikina Molecular Diagnostics Laboratory (MMDL),2020-05-21,32,31,0,31,0,0,51,423,1196,1129,63,1066,0.06,0.94,
Marikina Molecular Diagnostics Laboratory (MMDL),2020-05-22,142,137,1,136,0,0,40,433,1338,1266,64,1202,0.05,0.95,
Marikina Molecular Diagnostics Laboratory (MMDL),2020-05-23,290,272,10,262,0,0,28,193,1628,1538,74,1464,0.05,0.95,
Marikina Molecular Diagnostics Laboratory (MMDL),2020-05-24,0,0,0,0,0,0,0,0,1628,1538,74,1464,0.05,0.95,
Marikina Molecular Diagnostics Laboratory (MMDL),2020-05-25,41,34,2,32,0,0,35,152,1669,1572,76,1496,0.05,0.95,
Marikina Molecular Diagnostics Laboratory (MMDL),2020-05-26,175,160,14,146,0,0,84,0,1844,1732,90,1642,0.05,0.95,
Marikina Molecular Diagnostics Laboratory (MMDL),2020-05-27,188,182,4,178,0,1,226,0,2032,1914,94,1820,0.05,0.95,
Marikina Molecular Diagnostics Laboratory (MMDL),2020-05-28,174,169,10,159,0,0,151,0,2206,2083,104,1979,0.05,0.95,
Marikina Molecular Diagnostics Laboratory (MMDL),2020-05-29,130,128,2,126,0,0,176,0,2336,2211,106,2105,0.05,0.95,
Marikina Molecular Diagnostics Laboratory (MMDL),2020-05-30,178,167,5,162,0,0,158,0,2514,2378,111,2267,0.05,0.95,
Marikina Molecular Diagnostics Laboratory (MMDL),2020-05-31,0,0,0,0,0,0,158,0,2514,2378,111,2267,0.05,0.95,
Marikina Molecular Diagnostics Laboratory (MMDL),2020-06-01,130,130,6,124,0,0,161,0,2644,2508,117,2391,0.05,0.95,
Marikina Molecular Diagnostics Laboratory (MMDL),2020-06-02,129,127,3,124,0,0,161,0,2773,2635,120,2515,0.05,0.95,
Marikina Molecular Diagnostics Laboratory (MMDL),2020-06-03,102,100,2,98,0,0,177,0,2875,2735,122,2613,0.04,0.96,
Marikina Molecular Diagnostics Laboratory (MMDL),2020-06-04,124,124,3,121,0,0,170,0,2999,2859,125,2734,0.04,0.96,
Marikina Molecular Diagnostics Laboratory (MMDL),2020-06-05,262,257,13,244,0,0,163,0,3261,3116,138,2978,0.04,0.96,
Marikina Molecular Diagnostics Laboratory (MMDL),2020-06-06,0,0,0,0,0,0,145,0,3261,3116,138,2978,0.04,0.96,
Marikina Molecular Diagnostics Laboratory (MMDL),2020-06-07,0,0,0,0,0,0,145,0,3261,3116,138,2978,0.04,0.96,
Marikina Molecular Diagnostics Laboratory (MMDL),2020-06-08,110,108,7,101,0,0,145,0,3371,3224,145,3079,0.04,0.96,
Marikina Molecular Diagnostics Laboratory (MMDL),2020-06-09,124,122,12,110,0,0,1128,0,3495,3346,157,3189,0.05,0.95,
Marikina Molecular Diagnostics Laboratory (MMDL),2020-06-10,294,284,11,273,0,0,2746,0,3789,3630,168,3462,0.05,0.95,
Marikina Molecular Diagnostics Laboratory (MMDL),2020-06-11,101,100,25,75,0,0,2626,0,3890,3730,193,3537,0.05,0.95,
Marikina Molecular Diagnostics Laboratory (MMDL),2020-06-12,199,186,31,155,34,1,2410,0,4089,3916,224,3692,0.06,0.94,
Marikina Molecular Diagnostics Laboratory (MMDL),2020-06-13,1,1,1,0,0,0,2410,0,4090,3917,225,3692,0.06,0.94,
Marikina Molecular Diagnostics Laboratory (MMDL),2020-06-14,0,0,0,0,0,0,2410,0,4090,3917,225,3692,0.06,0.94,
Marikina Molecular Diagnostics Laboratory (MMDL),2020-06-15,144,144,13,131,0,0,1344,0,4234,4061,238,3823,0.06,0.94,
Marikina Molecular Diagnostics Laboratory (MMDL),2020-06-16,160,154,3,151,0,0,2312,0,4394,4215,241,3974,0.06,0.94,
Marikina Molecular Diagnostics Laboratory (MMDL),2020-06-17,208,208,15,193,0,0,1653,0,4602,4423,256,4167,0.06,0.94,
Marikina Molecular Diagnostics Laboratory (MMDL),2020-06-18,,,,,,,,,4602,4423,256,4167,0.06,0.94,
Marikina Molecular Diagnostics Laboratory (MMDL),2020-06-19,179,133,1,132,5,2,1473,0,4781,4556,257,4299,0.06,0.94,
Marikina Molecular Diagnostics Laboratory (MMDL),2020-06-20,71,51,1,50,0,17,1057,0,4852,4607,258,4349,0.06,0.94,
Marikina Molecular Diagnostics Laboratory (MMDL),2020-06-21,0,0,0,0,0,0,1057,0,4852,4607,258,4349,0.06,0.94,
Marikina Molecular Diagnostics Laboratory (MMDL),2020-06-22,128,124,12,112,0,0,1056,0,4980,4731,270,4461,0.06,0.94,
Marikina Molecular Diagnostics Laboratory (MMDL),2020-06-23,230,229,8,221,0,0,816,0,5210,4960,278,4682,0.06,0.94,
Marikina Molecular Diagnostics Laboratory (MMDL),2020-06-24,,,,,,,,,5210,4960,278,4682,0.06,0.94,
Marikina Molecular Diagnostics Laboratory (MMDL),2020-06-25,,,,,,,,,5210,4960,278,4682,0.06,0.94,
Marikina Molecular Diagnostics Laboratory (MMDL),2020-06-26,,,,,,,,,5210,4960,278,4682,0.06,0.94,
Marikina Molecular Diagnostics Laboratory (MMDL),2020-06-27,,,,,,,,,5210,4960,278,4682,0.06,0.94,
National Kidney and Transplant Institute,2020-05-28,30,30,2,28,0,0,130,0,30,30,2,28,0.07,0.93,
National Kidney and Transplant Institute,2020-05-29,30,30,2,28,0,0,100,0,60,60,4,56,0.07,0.93,
National Kidney and Transplant Institute,2020-05-30,40,40,4,36,0,0,66,0,100,100,8,92,0.08,0.92,
National Kidney and Transplant Institute,2020-05-31,36,36,7,29,0,0,360,0,136,136,15,121,0.11,0.89,
National Kidney and Transplant Institute,2020-06-01,48,48,14,34,0,0,2312,0,184,184,29,155,0.16,0.84,
National Kidney and Transplant Institute,2020-06-02,26,26,2,24,0,0,2256,0,210,210,31,179,0.15,0.85,
National Kidney and Transplant Institute,2020-06-03,89,89,8,81,0,0,2199,0,299,299,39,260,0.13,0.87,
National Kidney and Transplant Institute,2020-06-04,56,56,5,51,0,0,2151,4,355,355,44,311,0.12,0.88,
National Kidney and Transplant Institute,2020-06-05,49,49,6,43,0,0,2090,0,404,404,50,354,0.12,0.88,
National Kidney and Transplant Institute,2020-06-06,83,83,6,77,0,0,2039,0,487,487,56,431,0.11,0.89,
National Kidney and Transplant Institute,2020-06-07,0,0,0,0,0,0,2039,0,487,487,56,431,0.11,0.89,
National Kidney and Transplant Institute,2020-06-08,44,44,12,32,0,0,2339,8,531,531,68,463,0.13,0.87,
National Kidney and Transplant Institute,2020-06-09,39,39,7,32,0,0,2278,8,570,570,75,495,0.13,0.87,
National Kidney and Transplant Institute,2020-06-10,57,57,1,56,0,0,2150,19,627,627,76,551,0.12,0.88,
National Kidney and Transplant Institute,2020-06-11,75,71,10,61,0,4,2050,31,702,698,86,612,0.12,0.88,
National Kidney and Transplant Institute,2020-06-12,29,25,5,20,0,4,1970,19,731,723,91,632,0.13,0.87,
National Kidney and Transplant Institute,2020-06-13,84,83,7,76,0,1,1909,4,815,806,98,708,0.12,0.88,
National Kidney and Transplant Institute,2020-06-14,0,0,0,0,0,0,1909,4,815,806,98,708,0.12,0.88,
National Kidney and Transplant Institute,2020-06-15,78,70,3,67,0,8,1831,7,893,876,101,775,0.12,0.88,
National Kidney and Transplant Institute,2020-06-16,103,99,12,87,0,4,1728,0,996,975,113,862,0.12,0.88,
National Kidney and Transplant Institute,2020-06-17,133,132,11,121,0,1,1595,0,1129,1107,124,983,0.11,0.89,
National Kidney and Transplant Institute,2020-06-18,83,83,8,75,0,0,1429,0,1212,1190,132,1058,0.11,0.89,
National Kidney and Transplant Institute,2020-06-19,0,0,0,0,0,0,1429,0,1212,1190,132,1058,0.11,0.89,
National Kidney and Transplant Institute,2020-06-20,82,82,9,73,0,0,1347,0,1294,1272,141,1131,0.11,0.89,
National Kidney and Transplant Institute,2020-06-21,0,0,0,0,0,0,1347,0,1294,1272,141,1131,0.11,0.89,
National Kidney and Transplant Institute,2020-06-22,0,0,0,0,0,0,1347,0,1294,1272,141,1131,0.11,0.89,
National Kidney and Transplant Institute,2020-06-23,82,82,16,66,0,0,1265,0,1376,1354,157,1197,0.12,0.88,
National Kidney and Transplant Institute,2020-06-24,96,95,20,75,0,0,1169,1,1472,1449,177,1272,0.12,0.88,
National Kidney and Transplant Institute,2020-06-25,70,69,16,53,0,1,1099,0,1542,1518,193,1325,0.13,0.87,
National Kidney and Transplant Institute,2020-06-26,89,89,12,77,0,0,1010,0,1631,1607,205,1402,0.13,0.87,
National Kidney and Transplant Institute,2020-06-27,33,33,0,33,0,0,977,0,1664,1640,205,1435,0.13,0.88,
Northern Mindanao Medical Center GeneXpert Laboratory,2020-05-21,12,12,0,12,0,0,1728,0,12,12,0,12,0.0,1.0,
Northern Mindanao Medical Center GeneXpert Laboratory,2020-05-22,16,16,1,15,0,0,1712,0,28,28,1,27,0.04,0.96,
Northern Mindanao Medical Center GeneXpert Laboratory,2020-05-23,8,8,0,8,0,0,1705,5,36,36,1,35,0.03,0.97,
Northern Mindanao Medical Center GeneXpert Laboratory,2020-05-24,0,0,0,0,0,0,1704,5,36,36,1,35,0.03,0.97,
Northern Mindanao Medical Center GeneXpert Laboratory,2020-05-25,12,12,1,11,0,0,1692,28,48,48,2,46,0.04,0.96,
Northern Mindanao Medical Center GeneXpert Laboratory,2020-05-26,31,31,1,30,0,0,1660,0,79,79,3,76,0.04,0.96,
Northern Mindanao Medical Center GeneXpert Laboratory,2020-05-27,25,24,2,22,0,0,1634,0,104,103,5,98,0.05,0.95,
Northern Mindanao Medical Center GeneXpert Laboratory,2020-05-28,21,21,0,21,0,0,1611,0,125,124,5,119,0.04,0.96,
Northern Mindanao Medical Center GeneXpert Laboratory,2020-05-29,21,21,1,20,0,0,1590,0,146,145,6,139,0.04,0.96,
Northern Mindanao Medical Center GeneXpert Laboratory,2020-05-30,32,32,0,32,0,0,1558,0,178,177,6,171,0.03,0.97,
Northern Mindanao Medical Center GeneXpert Laboratory,2020-05-31,30,30,1,29,0,0,1527,0,208,207,7,200,0.03,0.97,
Northern Mindanao Medical Center GeneXpert Laboratory,2020-06-01,11,11,0,11,0,0,1516,0,219,218,7,211,0.03,0.97,
Northern Mindanao Medical Center GeneXpert Laboratory,2020-06-02,34,34,0,34,0,0,1456,0,253,252,7,245,0.03,0.97,
Northern Mindanao Medical Center GeneXpert Laboratory,2020-06-03,23,23,1,22,0,0,1432,0,276,275,8,267,0.03,0.97,
Northern Mindanao Medical Center GeneXpert Laboratory,2020-06-04,22,22,1,21,0,0,1410,0,298,297,9,288,0.03,0.97,
Northern Mindanao Medical Center GeneXpert Laboratory,2020-06-05,30,29,2,27,0,0,1379,0,328,326,11,315,0.03,0.97,
Northern Mindanao Medical Center GeneXpert Laboratory,2020-06-06,29,28,3,25,0,0,1349,0,357,354,14,340,0.04,0.96,
Northern Mindanao Medical Center GeneXpert Laboratory,2020-06-07,22,22,1,21,0,0,1327,0,379,376,15,361,0.04,0.96,
Northern Mindanao Medical Center GeneXpert Laboratory,2020-06-08,20,20,1,19,0,0,1307,0,399,396,16,380,0.04,0.96,
Northern Mindanao Medical Center GeneXpert Laboratory,2020-06-09,49,47,8,39,0,0,1272,0,448,443,24,419,0.05,0.95,
Northern Mindanao Medical Center GeneXpert Laboratory,2020-06-10,40,39,1,38,0,0,1228,0,488,482,25,457,0.05,0.95,
Northern Mindanao Medical Center GeneXpert Laboratory,2020-06-11,58,57,15,42,0,0,1162,0,546,539,40,499,0.07,0.93,
Northern Mindanao Medical Center GeneXpert Laboratory,2020-06-12,32,31,5,26,0,0,1130,0,578,570,45,525,0.08,0.92,
Northern Mindanao Medical Center GeneXpert Laboratory,2020-06-13,38,38,8,30,0,0,1092,0,616,608,53,555,0.09,0.91,
Northern Mindanao Medical Center GeneXpert Laboratory,2020-06-14,34,34,3,31,0,0,1052,0,650,642,56,586,0.09,0.91,
Northern Mindanao Medical Center GeneXpert Laboratory,2020-06-15,56,55,8,47,0,0,1000,0,706,697,64,633,0.09,0.91,
Northern Mindanao Medical Center GeneXpert Laboratory,2020-06-16,29,29,2,27,0,0,968,0,735,726,66,660,0.09,0.91,
Northern Mindanao Medical Center GeneXpert Laboratory,2020-06-17,51,50,6,44,0,0,915,0,786,776,72,704,0.09,0.91,
Northern Mindanao Medical Center GeneXpert Laboratory,2020-06-18,42,40,2,38,0,0,873,0,828,816,74,742,0.09,0.91,
Northern Mindanao Medical Center GeneXpert Laboratory,2020-06-19,27,27,1,26,0,0,864,0,855,843,75,768,0.09,0.91,
Northern Mindanao Medical Center GeneXpert Laboratory,2020-06-20,24,24,1,23,0,0,822,0,879,867,76,791,0.09,0.91,
Northern Mindanao Medical Center GeneXpert Laboratory,2020-06-21,100,100,14,86,0,0,715,0,979,967,90,877,0.09,0.91,
Northern Mindanao Medical Center GeneXpert Laboratory,2020-06-22,27,7,3,4,0,0,688,0,1006,974,93,881,0.1,0.9,
Northern Mindanao Medical Center GeneXpert Laboratory,2020-06-23,15,15,0,15,0,0,673,0,1021,989,93,896,0.09,0.91,
Northern Mindanao Medical Center GeneXpert Laboratory,2020-06-24,6,6,0,6,0,0,666,0,1027,995,93,902,0.09,0.91,
Northern Mindanao Medical Center GeneXpert Laboratory,2020-06-25,9,9,0,9,0,0,657,0,1036,1004,93,911,0.09,0.91,
Northern Mindanao Medical Center GeneXpert Laboratory,2020-06-26,12,12,0,12,0,0,1725,0,1048,1016,93,923,0.09,0.91,
Northern Mindanao Medical Center GeneXpert Laboratory,2020-06-27,12,12,2,10,0,0,1713,0,1060,1028,95,933,0.09,0.91,
Northern Mindanao TB Regional Center,2020-06-17,46,46,4,42,0,0,4042,0,46,46,4,42,0.09,0.91,
Northern Mindanao TB Regional Center,2020-06-18,41,41,3,38,0,0,3996,0,87,87,7,80,0.08,0.92,
Northern Mindanao TB Regional Center,2020-06-19,45,45,6,39,0,0,4100,0,132,132,13,119,0.1,0.9,
Northern Mindanao TB Regional Center,2020-06-20,0,0,0,0,0,0,4100,0,132,132,13,119,0.1,0.9,
Northern Mindanao TB Regional Center,2020-06-21,0,0,0,0,0,0,4100,0,132,132,13,119,0.1,0.9,
Northern Mindanao TB Regional Center,2020-06-22,53,47,7,40,0,0,2608,0,185,179,20,159,0.11,0.89,
Northern Mindanao TB Regional Center,2020-06-23,94,94,7,87,0,0,2616,0,279,273,27,246,0.1,0.9,
Northern Mindanao TB Regional Center,2020-06-24,0,0,0,0,0,0,2430,0,279,273,27,246,0.1,0.9,
Northern Mindanao TB Regional Center,2020-06-25,160,160,11,149,0,0,2250,0,439,433,38,395,0.09,0.91,
Northern Mindanao TB Regional Center,2020-06-26,0,0,0,0,0,0,2160,0,439,433,38,395,0.09,0.91,
Northern Mindanao TB Regional Center,2020-06-27,158,157,21,136,0,1,2070,0,597,590,59,531,0.1,0.9,
Oriental Mindoro Provincial Hospital GeneXpert Laboratory,2020-06-10,12,12,1,11,0,0,588,0,12,12,1,11,0.08,0.92,
Oriental Mindoro Provincial Hospital GeneXpert Laboratory,2020-06-11,21,21,0,21,0,0,567,0,33,33,1,32,0.03,0.97,
Oriental Mindoro Provincial Hospital GeneXpert Laboratory,2020-06-12,21,21,0,21,0,0,546,0,54,54,1,53,0.02,0.98,
Oriental Mindoro Provincial Hospital GeneXpert Laboratory,2020-06-13,24,24,0,24,0,0,522,0,78,78,1,77,0.01,0.99,
Oriental Mindoro Provincial Hospital GeneXpert Laboratory,2020-06-14,0,0,0,0,0,0,0,0,78,78,1,77,0.01,0.99,
Oriental Mindoro Provincial Hospital GeneXpert Laboratory,2020-06-15,23,23,0,23,0,0,499,0,101,101,1,100,0.01,0.99,
Oriental Mindoro Provincial Hospital GeneXpert Laboratory,2020-06-16,13,13,1,12,0,0,486,0,114,114,2,112,0.02,0.98,
Oriental Mindoro Provincial Hospital GeneXpert Laboratory,2020-06-17,11,11,0,11,0,0,475,0,125,125,2,123,0.02,0.98,
Oriental Mindoro Provincial Hospital GeneXpert Laboratory,2020-06-18,11,11,0,11,0,0,464,0,136,136,2,134,0.01,0.99,
Oriental Mindoro Provincial Hospital GeneXpert Laboratory,2020-06-19,11,11,0,11,0,0,453,0,147,147,2,145,0.01,0.99,
Oriental Mindoro Provincial Hospital GeneXpert Laboratory,2020-06-20,10,10,0,10,0,0,443,0,157,157,2,155,0.01,0.99,
Oriental Mindoro Provincial Hospital GeneXpert Laboratory,2020-06-21,0,0,0,0,0,0,0,0,157,157,2,155,0.01,0.99,
Oriental Mindoro Provincial Hospital GeneXpert Laboratory,2020-06-22,19,19,0,19,0,0,424,0,176,176,2,174,0.01,0.99,
Oriental Mindoro Provincial Hospital GeneXpert Laboratory,2020-06-23,9,9,0,9,0,0,415,0,185,185,2,183,0.01,0.99,
Oriental Mindoro Provincial Hospital GeneXpert Laboratory,2020-06-24,11,10,0,10,0,0,404,0,196,195,2,193,0.01,0.99,
Oriental Mindoro Provincial Hospital GeneXpert Laboratory,2020-06-25,22,21,0,21,0,0,382,0,218,216,2,214,0.01,0.99,
Oriental Mindoro Provincial Hospital GeneXpert Laboratory,2020-06-26,30,30,0,30,0,0,352,0,248,246,2,244,0.01,0.99,
Oriental Mindoro Provincial Hospital GeneXpert Laboratory,2020-06-27,13,13,0,13,0,0,339,0,261,259,2,257,0.01,0.99,
Ospital ng Imus,2020-06-09,38,38,0,38,0,0,9720,0,38,38,0,38,0.0,1.0,
Ospital ng Imus,2020-06-10,27,27,0,27,0,0,9696,0,65,65,0,65,0.0,1.0,
Ospital ng Imus,2020-06-11,,,,,,,,,65,65,0,65,0.0,1.0,
Ospital ng Imus,2020-06-12,,,,,,,,,65,65,0,65,0.0,1.0,
Ospital ng Imus,2020-06-13,97,97,0,97,0,0,9504,0,162,162,0,162,0.0,1.0,
Ospital ng Imus,2020-06-14,64,64,0,64,0,0,9192,0,226,226,0,226,0.0,1.0,
Ospital ng Imus,2020-06-15,,,,,,,,,226,226,0,226,0.0,1.0,
Ospital ng Imus,2020-06-16,92,92,0,92,0,0,9096,0,318,318,0,318,0.0,1.0,
Ospital ng Imus,2020-06-17,147,147,0,147,0,0,9096,0,465,465,0,465,0.0,1.0,
Ospital ng Imus,2020-06-18,66,66,0,66,0,0,8856,0,531,531,0,531,0.0,1.0,
Ospital ng Imus,2020-06-19,169,169,0,169,0,0,8640,169,700,700,0,700,0.0,1.0,
Ospital ng Imus,2020-06-20,176,176,0,176,0,0,8424,345,876,876,0,876,0.0,1.0,
Ospital ng Imus,2020-06-21,90,90,1,89,0,0,8352,343,966,966,1,965,0.0,1.0,
Ospital ng Imus,2020-06-22,92,92,0,92,0,0,8208,182,1058,1058,1,1057,0.0,1.0,
Ospital ng Imus,2020-06-23,170,170,0,170,0,0,7920,170,1228,1228,1,1227,0.0,1.0,
Ospital ng Imus,2020-06-24,89,89,8,81,0,0,7872,259,1317,1317,9,1308,0.01,0.99,
Ospital ng Imus,2020-06-25,,,,,,,,,1317,1317,9,1308,0.01,0.99,
Ospital ng Imus,2020-06-26,,,,,,,,,1317,1317,9,1308,0.01,0.99,
Ospital ng Imus,2020-06-27,92,92,2,90,0,0,7488,0,1409,1409,11,1398,0.01,0.99,
Ospital ng Palawan GeneXpert Laboratory,2020-05-20,2,2,0,2,0,0,595,0,2,2,0,2,0.0,1.0,
Ospital ng Palawan GeneXpert Laboratory,2020-05-21,0,0,0,0,0,0,595,0,2,2,0,2,0.0,1.0,
Ospital ng Palawan GeneXpert Laboratory,2020-05-22,0,0,0,0,0,0,595,0,2,2,0,2,0.0,1.0,
Ospital ng Palawan GeneXpert Laboratory,2020-05-23,1,1,0,1,0,0,594,0,3,3,0,3,0.0,1.0,
Ospital ng Palawan GeneXpert Laboratory,2020-05-24,0,0,0,0,0,0,594,0,3,3,0,3,0.0,1.0,
Ospital ng Palawan GeneXpert Laboratory,2020-05-25,4,4,0,4,0,0,590,0,7,7,0,7,0.0,1.0,
Ospital ng Palawan GeneXpert Laboratory,2020-05-26,1,1,0,1,0,0,589,0,8,8,0,8,0.0,1.0,
Ospital ng Palawan GeneXpert Laboratory,2020-05-27,2,2,0,2,0,0,587,0,10,10,0,10,0.0,1.0,
Ospital ng Palawan GeneXpert Laboratory,2020-05-28,0,0,0,0,0,0,587,0,10,10,0,10,0.0,1.0,
Ospital ng Palawan GeneXpert Laboratory,2020-05-29,0,0,0,0,0,0,587,0,10,10,0,10,0.0,1.0,
Ospital ng Palawan GeneXpert Laboratory,2020-05-30,6,6,0,6,0,0,581,0,16,16,0,16,0.0,1.0,
Ospital ng Palawan GeneXpert Laboratory,2020-05-31,18,18,0,18,0,0,743,0,34,34,0,34,0.0,1.0,
Ospital ng Palawan GeneXpert Laboratory,2020-06-01,3,3,0,3,0,0,740,0,37,37,0,37,0.0,1.0,
Ospital ng Palawan GeneXpert Laboratory,2020-06-02,1,1,0,1,0,0,739,0,38,38,0,38,0.0,1.0,
Ospital ng Palawan GeneXpert Laboratory,2020-06-03,5,5,1,4,0,0,734,0,43,43,1,42,0.02,0.98,
Ospital ng Palawan GeneXpert Laboratory,2020-06-04,3,3,0,3,0,0,730,0,46,46,1,45,0.02,0.98,
Ospital ng Palawan GeneXpert Laboratory,2020-06-05,11,11,0,11,0,0,719,0,57,57,1,56,0.02,0.98,
Ospital ng Palawan GeneXpert Laboratory,2020-06-06,4,4,0,4,0,0,715,0,61,61,1,60,0.02,0.98,
Ospital ng Palawan GeneXpert Laboratory,2020-06-07,9,9,0,9,0,0,706,0,70,70,1,69,0.01,0.99,
Ospital ng Palawan GeneXpert Laboratory,2020-06-08,1,1,0,1,0,0,705,0,71,71,1,70,0.01,0.99,
Ospital ng Palawan GeneXpert Laboratory,2020-06-09,18,18,1,17,0,0,687,0,89,89,2,87,0.02,0.98,
Ospital ng Palawan GeneXpert Laboratory,2020-06-10,13,13,0,13,0,0,674,0,102,102,2,100,0.02,0.98,
Ospital ng Palawan GeneXpert Laboratory,2020-06-11,9,9,0,9,0,0,665,0,111,111,2,109,0.02,0.98,
Ospital ng Palawan GeneXpert Laboratory,2020-06-12,2,2,0,2,0,0,663,0,113,113,2,111,0.02,0.98,
Ospital ng Palawan GeneXpert Laboratory,2020-06-13,20,20,0,20,0,0,643,0,133,133,2,131,0.02,0.98,
Ospital ng Palawan GeneXpert Laboratory,2020-06-14,10,10,0,10,0,0,633,0,143,143,2,141,0.01,0.99,
Ospital ng Palawan GeneXpert Laboratory,2020-06-15,2,2,0,2,0,0,631,0,145,145,2,143,0.01,0.99,
Ospital ng Palawan GeneXpert Laboratory,2020-06-16,8,8,1,7,0,0,623,0,153,153,3,150,0.02,0.98,
Ospital ng Palawan GeneXpert Laboratory,2020-06-17,28,28,4,24,0,0,595,0,181,181,7,174,0.04,0.96,
Ospital ng Palawan GeneXpert Laboratory,2020-06-18,8,8,2,6,0,0,587,0,189,189,9,180,0.05,0.95,
Ospital ng Palawan GeneXpert Laboratory,2020-06-19,27,27,4,23,0,0,560,0,216,216,13,203,0.06,0.94,
Ospital ng Palawan GeneXpert Laboratory,2020-06-20,12,12,,12,0,0,548,0,228,228,13,215,0.06,0.94,For Review
Ospital ng Palawan GeneXpert Laboratory,2020-06-21,48,48,2,46,0,0,500,0,276,276,15,261,0.05,0.95,
Ospital ng Palawan GeneXpert Laboratory,2020-06-22,40,40,0,40,0,0,460,0,316,316,15,301,0.05,0.95,
Ospital ng Palawan GeneXpert Laboratory,2020-06-23,36,36,0,36,0,0,424,0,352,352,15,337,0.04,0.96,
Ospital ng Palawan GeneXpert Laboratory,2020-06-24,48,48,3,45,0,0,376,0,400,400,18,382,0.04,0.95,
Ospital ng Palawan GeneXpert Laboratory,2020-06-25,41,41,6,35,0,0,335,0,441,441,24,417,0.05,0.95,
Ospital ng Palawan GeneXpert Laboratory,2020-06-26,30,29,3,26,1,0,305,0,471,470,27,443,0.06,0.94,
Ospital ng Palawan GeneXpert Laboratory,2020-06-27,1,1,0,1,0,0,304,0,472,471,27,444,0.06,0.94,
PNP Crime Laboratory,2020-05-25,0,0,0,0,0,0,0,0,0,0,0,0,,,
PNP Crime Laboratory,2020-05-26,0,0,0,0,0,0,1800,0,0,0,0,0,,,
PNP Crime Laboratory,2020-05-27,0,0,0,0,0,0,1800,0,0,0,0,0,,,
PNP Crime Laboratory,2020-05-28,0,0,0,0,0,0,1800,0,0,0,0,0,,,
PNP Crime Laboratory,2020-05-29,0,0,0,0,0,0,1800,0,0,0,0,0,,,
PNP Crime Laboratory,2020-05-30,0,0,0,0,0,0,1800,0,0,0,0,0,,,
PNP Crime Laboratory,2020-05-31,0,0,0,0,0,0,1800,0,0,0,0,0,,,
PNP Crime Laboratory,2020-06-01,0,0,0,0,0,0,1800,0,0,0,0,0,,,
PNP Crime Laboratory,2020-06-02,0,0,0,0,0,0,1800,0,0,0,0,0,,,
PNP Crime Laboratory,2020-06-03,34,34,1,33,0,0,1766,0,34,34,1,33,0.03,0.97,
PNP Crime Laboratory,2020-06-04,0,0,0,0,0,0,1766,0,34,34,1,33,0.03,0.97,
PNP Crime Laboratory,2020-06-05,21,21,0,21,0,0,1745,0,55,55,1,54,0.02,0.98,
PNP Crime Laboratory,2020-06-06,23,23,0,23,0,0,1722,0,78,78,1,77,0.01,0.99,
PNP Crime Laboratory,2020-06-07,0,0,0,0,0,0,1626,0,78,78,1,77,0.01,0.99,
PNP Crime Laboratory,2020-06-08,0,0,0,0,0,0,1626,0,78,78,1,77,0.01,0.99,
PNP Crime Laboratory,2020-06-09,0,0,0,0,0,0,1626,0,78,78,1,77,0.01,0.99,
PNP Crime Laboratory,2020-06-10,9,9,2,7,0,0,1617,0,87,87,3,84,0.03,0.97,
PNP Crime Laboratory,2020-06-11,0,0,0,0,0,0,1617,0,87,87,3,84,0.03,0.97,
PNP Crime Laboratory,2020-06-12,0,0,0,0,0,0,1617,0,87,87,3,84,0.03,0.97,
PNP Crime Laboratory,2020-06-13,0,0,0,0,0,0,1617,0,87,87,3,84,0.03,0.97,
PNP Crime Laboratory,2020-06-14,30,30,3,27,0,0,1587,0,117,117,6,111,0.05,0.95,
PNP Crime Laboratory,2020-06-15,1,1,1,0,0,0,0,0,118,118,7,111,0.06,0.94,
PNP Crime Laboratory,2020-06-16,5,5,0,5,0,0,1581,0,123,123,7,116,0.06,0.94,
PNP Crime Laboratory,2020-06-17,57,57,3,54,0,0,3444,0,180,180,10,170,0.06,0.94,
PNP Crime Laboratory,2020-06-18,15,15,0,15,0,0,3429,0,195,195,10,185,0.05,0.95,
PNP Crime Laboratory,2020-06-19,94,94,21,73,0,0,3297,0,289,289,31,258,0.11,0.89,
PNP Crime Laboratory,2020-06-20,50,50,3,47,0,0,3232,0,339,339,34,305,0.1,0.9,
PNP Crime Laboratory,2020-06-21,0,0,0,0,0,0,3260,0,339,339,34,305,0.1,0.9,
PNP Crime Laboratory,2020-06-22,0,0,0,0,0,0,3260,0,339,339,34,305,0.1,0.9,
PNP Crime Laboratory,2020-06-23,96,96,3,93,0,0,3147,0,435,435,37,398,0.09,0.91,
PNP Crime Laboratory,2020-06-24,46,46,4,42,0,0,3087,0,481,481,41,440,0.09,0.91,
PNP Crime Laboratory,2020-06-25,10,10,0,10,0,0,3073,0,491,491,41,450,0.08,0.92,
PNP Crime Laboratory,2020-06-26,19,19,0,19,0,0,3048,0,510,510,41,469,0.08,0.92,
PNP Crime Laboratory,2020-06-27,45,45,0,45,0,0,2996,0,555,555,41,514,0.07,0.93,
Philippine Red Cross (PRC),2020-04-14,90,90,2,88,,,10000,,90,90,2,88,0.02,0.98,
Philippine Red Cross (PRC),2020-04-15,136,136,2,134,,,10000,,226,226,4,222,0.02,0.98,
Philippine Red Cross (PRC),2020-04-16,101,101,1,100,,,10000,,327,327,5,322,0.02,0.98,
Philippine Red Cross (PRC),2020-04-17,288,288,8,280,,,10000,,615,615,13,602,0.02,0.98,
Philippine Red Cross (PRC),2020-04-18,399,399,23,376,,,11180,,1014,1014,36,978,0.04,0.96,
Philippine Red Cross (PRC),2020-04-19,576,576,55,521,,,81672,,1590,1590,91,1499,0.06,0.94,
Philippine Red Cross (PRC),2020-04-20,99,99,6,93,,,81672,,1689,1689,97,1592,0.06,0.94,
Philippine Red Cross (PRC),2020-04-21,196,196,53,143,,,70000,,1885,1885,150,1735,0.08,0.92,
Philippine Red Cross (PRC),2020-04-22,217,217,10,207,,,70000,,2102,2102,160,1942,0.08,0.92,
Philippine Red Cross (PRC),2020-04-23,626,626,59,567,,,70000,,2728,2728,219,2509,0.08,0.92,
Philippine Red Cross (PRC),2020-04-24,895,895,75,820,,,70000,,3623,3623,294,3329,0.08,0.92,
Philippine Red Cross (PRC),2020-04-25,843,843,33,810,,,70000,,4466,4466,327,4139,0.07,0.93,
Philippine Red Cross (PRC),2020-04-26,236,236,9,227,,,70000,,4702,4702,336,4366,0.07,0.93,
Philippine Red Cross (PRC),2020-04-27,534,534,25,509,,,70000,,5236,5236,361,4875,0.07,0.93,
Philippine Red Cross (PRC),2020-04-28,704,704,37,667,,,70000,,5940,5940,398,5542,0.07,0.93,
Philippine Red Cross (PRC),2020-04-29,257,257,8,249,,,70000,,6197,6197,406,5791,0.07,0.93,
Philippine Red Cross (PRC),2020-04-30,879,879,47,832,,,70000,,7076,7076,453,6623,0.06,0.94,
Philippine Red Cross (PRC),2020-05-01,540,540,15,525,,,70000,,7616,7616,468,7148,0.06,0.94,
Philippine Red Cross (PRC),2020-05-02,413,413,38,375,,,70000,,8029,8029,506,7523,0.06,0.94,
Philippine Red Cross (PRC),2020-05-03,269,269,24,245,,,70000,,8298,8298,530,7768,0.06,0.94,
Philippine Red Cross (PRC),2020-05-04,624,624,34,590,,,70000,,8922,8922,564,8358,0.06,0.94,
Philippine Red Cross (PRC),2020-05-05,1514,1514,66,1448,,,70000,,10436,10436,630,9806,0.06,0.94,
Philippine Red Cross (PRC),2020-05-06,789,789,26,763,,,70000,,11225,11225,656,10569,0.06,0.94,
Philippine Red Cross (PRC),2020-05-07,896,896,55,841,,,70000,,12121,12121,711,11410,0.06,0.94,
Philippine Red Cross (PRC),2020-05-08,796,796,70,726,,,70000,,12917,12917,781,12136,0.06,0.94,
Philippine Red Cross (PRC),2020-05-09,1437,1437,75,1362,,,70000,,14354,14354,856,13498,0.06,0.94,
Philippine Red Cross (PRC),2020-05-10,1706,1706,64,1642,,,70000,,16060,16060,920,15140,0.06,0.94,
Philippine Red Cross (PRC),2020-05-11,2054,2054,74,1980,,,130000,,18114,18114,994,17120,0.05,0.95,
Philippine Red Cross (PRC),2020-05-12,2070,2070,116,1954,,,130000,,20184,20184,1110,19074,0.05,0.95,
Philippine Red Cross (PRC),2020-05-13,2155,2155,39,2116,,,130000,,22339,22339,1149,21190,0.05,0.95,
Philippine Red Cross (PRC),2020-05-14,2610,2610,50,2560,,,70000,,24949,24949,1199,23750,0.05,0.95,
Philippine Red Cross (PRC),2020-05-15,2700,2700,36,2664,,,70000,,27649,27649,1235,26414,0.04,0.96,
Philippine Red Cross (PRC),2020-05-16,2239,2239,33,2206,0,0,60000,,29888,29888,1268,28620,0.04,0.96,
Philippine Red Cross (PRC),2020-05-17,2610,2607,30,2577,0,0,60000,,32498,32495,1298,31197,0.04,0.96,
Philippine Red Cross (PRC),2020-05-18,630,629,23,606,0,0,60000,,33128,33124,1321,31803,0.04,0.96,
Philippine Red Cross (PRC),2020-05-19,800,800,21,779,0,0,60000,0,33928,33924,1342,32582,0.04,0.96,
Philippine Red Cross (PRC),2020-05-20,900,900,10,890,0,0,60000,0,34828,34824,1352,33472,0.04,0.96,
Philippine Red Cross (PRC),2020-05-21,1080,1079,52,1027,0,0,50000,0,35908,35903,1404,34499,0.04,0.96,
Philippine Red Cross (PRC),2020-05-22,900,891,46,845,0,0,50000,0,36808,36794,1450,35344,0.04,0.96,
Philippine Red Cross (PRC),2020-05-23,715,609,21,588,0,0,50000,0,37523,37403,1471,35932,0.04,0.96,
Philippine Red Cross (PRC),2020-05-24,978,720,14,706,0,0,50000,0,38501,38123,1485,36638,0.04,0.96,
Philippine Red Cross (PRC),2020-05-25,1170,1170,82,1088,0,0,50000,0,39671,39293,1567,37726,0.04,0.96,
Philippine Red Cross (PRC),2020-05-26,360,266,29,237,0,0,50000,0,40031,39559,1596,37963,0.04,0.96,
Philippine Red Cross (PRC),2020-05-27,460,450,15,435,0,0,50000,0,40491,40009,1611,38398,0.04,0.96,
Philippine Red Cross (PRC),2020-05-28,0,0,0,0,0,0,50000,0,40491,40009,1611,38398,0.04,0.96,
Philippine Red Cross (PRC),2020-05-29,0,0,0,0,0,0,50000,0,40491,40009,1611,38398,0.04,0.96,
Philippine Red Cross (PRC),2020-05-30,0,0,0,0,0,0,50000,0,40491,40009,1611,38398,0.04,0.96,
Philippine Red Cross (PRC),2020-05-31,270,233,9,224,0,0,50000,0,40761,40242,1620,38622,0.04,0.96,
Philippine Red Cross (PRC),2020-06-01,180,166,9,157,0,0,50000,0,40941,40408,1629,38779,0.04,0.96,
Philippine Red Cross (PRC),2020-06-02,270,269,36,233,0,0,50000,0,41211,40677,1665,39012,0.04,0.96,
Philippine Red Cross (PRC),2020-06-03,360,359,9,350,0,0,50000,0,41571,41036,1674,39362,0.04,0.96,
Philippine Red Cross (PRC),2020-06-04,0,0,0,0,0,0,50000,0,41571,41036,1674,39362,0.04,0.96,
Philippine Red Cross (PRC),2020-06-05,180,180,3,177,0,0,40000,0,41751,41216,1677,39539,0.04,0.96,
Philippine Red Cross (PRC),2020-06-06,990,945,43,902,0,0,40000,0,42741,42161,1720,40441,0.04,0.96,
Philippine Red Cross (PRC),2020-06-07,270,123,0,123,0,0,40000,0,43011,42284,1720,40564,0.04,0.96,
Philippine Red Cross (PRC),2020-06-08,540,532,44,488,0,0,40000,0,43551,42816,1764,41052,0.04,0.96,
Philippine Red Cross (PRC),2020-06-09,990,984,35,949,0,0,40000,0,44541,43800,1799,42001,0.04,0.96,
Philippine Red Cross (PRC),2020-06-10,887,841,30,811,0,0,40000,0,45428,44641,1829,42812,0.04,0.96,
Philippine Red Cross (PRC),2020-06-11,270,270,6,264,0,0,40000,0,45698,44911,1835,43076,0.04,0.96,
Philippine Red Cross (PRC),2020-06-12,0,0,0,0,0,0,40000,0,45698,44911,1835,43076,0.04,0.96,
Philippine Red Cross (PRC),2020-06-13,175,175,9,166,0,0,40000,0,45873,45086,1844,43242,0.04,0.96,
Philippine Red Cross (PRC),2020-06-14,0,0,0,0,0,0,40000,0,45873,45086,1844,43242,0.04,0.96,
Philippine Red Cross (PRC),2020-06-15,989,980,38,942,0,0,40000,0,46862,46066,1882,44184,0.04,0.96,
Philippine Red Cross (PRC),2020-06-16,900,885,4,881,0,0,40000,0,47762,46951,1886,45065,0.04,0.96,
Philippine Red Cross (PRC),2020-06-17,1710,1542,0,1542,0,0,40000,0,49472,48493,1886,46607,0.04,0.96,
Philippine Red Cross (PRC),2020-06-18,360,338,1,337,0,0,30000,0,49832,48831,1887,46944,0.04,0.96,
Philippine Red Cross (PRC),2020-06-19,0,0,0,0,0,0,30000,0,49832,48831,1887,46944,0.04,0.96,
Philippine Red Cross (PRC),2020-06-20,0,0,0,0,0,0,44000,0,49832,48831,1887,46944,0.04,0.96,
Philippine Red Cross (PRC),2020-06-21,0,0,0,0,0,0,30000,0,49832,48831,1887,46944,0.04,0.96,
Philippine Red Cross (PRC),2020-06-22,0,0,0,0,0,0,30000,0,49832,48831,1887,46944,0.04,0.96,
Philippine Red Cross (PRC),2020-06-23,720,705,7,698,0,0,30000,0,50552,49536,1894,47642,0.04,0.96,
Philippine Red Cross (PRC),2020-06-24,990,988,55,933,0,0,25000,0,51542,50524,1949,48575,0.04,0.96,
Philippine Red Cross (PRC),2020-06-25,540,537,21,516,0,0,25000,0,52082,51061,1970,49091,0.04,0.96,
Philippine Red Cross (PRC),2020-06-26,810,807,29,778,0,0,20000,0,52892,51868,1999,49869,0.04,0.96,
Philippine Red Cross (PRC),2020-06-27,,,,,,,,,52892,51868,1999,49869,0.04,0.96,
Philippine Red Cross - Logistics and Training Center,2020-06-18,74,74,0,74,0,0,4926,0,74,74,0,74,0.0,1.0,
Philippine Red Cross - Logistics and Training Center,2020-06-19,,,,,,,,,74,74,0,74,0.0,1.0,
Philippine Red Cross - Logistics and Training Center,2020-06-20,,,,,,,,,74,74,0,74,0.0,1.0,
Philippine Red Cross - Logistics and Training Center,2020-06-21,,,,,,,,,74,74,0,74,0.0,1.0,
Philippine Red Cross - Logistics and Training Center,2020-06-22,,,,,,,,,74,74,0,74,0.0,1.0,
Philippine Red Cross - Logistics and Training Center,2020-06-23,,,,,,,,,74,74,0,74,0.0,1.0,
Philippine Red Cross - Logistics and Training Center,2020-06-24,150,150,0,150,0,0,4850,0,224,224,0,224,0.0,1.0,
Philippine Red Cross - Logistics and Training Center,2020-06-25,73,73,0,73,0,0,4777,0,297,297,0,297,0.0,1.0,
Philippine Red Cross - Logistics and Training Center,2020-06-26,0,0,0,0,0,0,4703,0,297,297,0,297,0.0,1.0,
Philippine Red Cross - Logistics and Training Center,2020-06-27,,,,,,,,,297,297,0,297,0.0,1.0,
Philippine Red Cross - Port Area,2020-05-19,540,534,22,512,0,6,,0,540,534,22,512,0.04,0.96,
Philippine Red Cross - Port Area,2020-05-20,720,720,11,709,0,0,0,0,1260,1254,33,1221,0.03,0.97,
Philippine Red Cross - Port Area,2020-05-21,270,270,6,264,0,0,0,0,1530,1524,39,1485,0.03,0.97,
Philippine Red Cross - Port Area,2020-05-22,270,267,11,256,0,0,0,0,1800,1791,50,1741,0.03,0.97,
Philippine Red Cross - Port Area,2020-05-23,90,90,4,86,0,0,0,0,1890,1881,54,1827,0.03,0.97,
Philippine Red Cross - Port Area,2020-05-24,606,605,2,603,0,1,0,0,2496,2486,56,2430,0.02,0.98,
Philippine Red Cross - Port Area,2020-05-25,180,180,16,164,0,0,0,0,2676,2666,72,2594,0.03,0.97,
Philippine Red Cross - Port Area,2020-05-26,660,660,12,648,0,0,0,0,3336,3326,84,3242,0.03,0.97,
Philippine Red Cross - Port Area,2020-05-27,55,55,0,55,0,0,0,0,3391,3381,84,3297,0.02,0.98,
Philippine Red Cross - Port Area,2020-05-28,1676,1673,53,1620,0,3,0,0,5067,5054,137,4917,0.03,0.97,
Philippine Red Cross - Port Area,2020-05-29,1170,1170,42,1128,0,0,0,0,6237,6224,179,6045,0.03,0.97,
Philippine Red Cross - Port Area,2020-05-30,629,629,4,625,0,0,0,0,6866,6853,183,6670,0.03,0.97,
Philippine Red Cross - Port Area,2020-05-31,1646,1556,22,1534,0,90,0,0,8512,8409,205,8204,0.02,0.98,
Philippine Red Cross - Port Area,2020-06-01,534,530,23,507,0,4,0,0,9046,8939,228,8711,0.03,0.97,
Philippine Red Cross - Port Area,2020-06-02,900,895,41,854,0,5,0,0,9946,9834,269,9565,0.03,0.97,
Philippine Red Cross - Port Area,2020-06-03,85,84,1,83,0,1,0,0,10031,9918,270,9648,0.03,0.97,
Philippine Red Cross - Port Area,2020-06-04,746,746,4,742,0,0,0,0,10777,10664,274,10390,0.03,0.97,
Philippine Red Cross - Port Area,2020-06-05,,,,,,,,,10777,10664,274,10390,0.03,0.97,
Philippine Red Cross - Port Area,2020-06-06,453,274,3,271,0,0,1000,0,11230,10938,277,10661,0.03,0.97,
Philippine Red Cross - Port Area,2020-06-07,180,176,0,176,0,4,0,0,11410,11114,277,10837,0.02,0.98,
Philippine Red Cross - Port Area,2020-06-08,177,176,0,176,0,2,0,0,11587,11290,277,11013,0.02,0.98,
Philippine Red Cross - Port Area,2020-06-09,135,135,0,135,0,0,0,0,11722,11425,277,11148,0.02,0.98,
Philippine Red Cross - Port Area,2020-06-10,213,212,8,204,0,0,0,0,11935,11637,285,11352,0.02,0.98,
Philippine Red Cross - Port Area,2020-06-11,0,0,0,0,0,0,0,0,11935,11637,285,11352,0.02,0.98,
Philippine Red Cross - Port Area,2020-06-12,0,0,0,0,0,0,0,0,11935,11637,285,11352,0.02,0.98,
Philippine Red Cross - Port Area,2020-06-13,0,0,0,0,0,0,0,0,11935,11637,285,11352,0.02,0.98,
Philippine Red Cross - Port Area,2020-06-14,0,0,0,0,0,0,0,0,11935,11637,285,11352,0.02,0.98,
Philippine Red Cross - Port Area,2020-06-15,0,0,0,0,0,0,0,0,11935,11637,285,11352,0.02,0.98,
Philippine Red Cross - Port Area,2020-06-16,0,0,0,0,0,0,0,0,11935,11637,285,11352,0.02,0.98,
Philippine Red Cross - Port Area,2020-06-17,0,0,0,0,0,0,0,0,11935,11637,285,11352,0.02,0.98,
Philippine Red Cross - Port Area,2020-06-18,0,0,0,0,0,0,0,0,11935,11637,285,11352,0.02,0.98,
Philippine Red Cross - Port Area,2020-06-19,0,0,0,0,0,0,0,0,11935,11637,285,11352,0.02,0.98,
Philippine Red Cross - Port Area,2020-06-20,0,0,0,0,0,0,0,0,11935,11637,285,11352,0.02,0.98,
Philippine Red Cross - Port Area,2020-06-21,0,0,0,0,0,0,0,0,11935,11637,285,11352,0.02,0.98,
Philippine Red Cross - Port Area,2020-06-22,630,630,3,627,0,0,0,0,12565,12267,288,11979,0.02,0.98,
Philippine Red Cross - Port Area,2020-06-23,1350,1348,96,1252,0,2,0,0,13915,13615,384,13231,0.03,0.97,
Philippine Red Cross - Port Area,2020-06-24,1080,1079,40,1039,0,1,0,0,14995,14694,424,14270,0.03,0.97,
Philippine Red Cross - Port Area,2020-06-25,,,,,,,,,14995,14694,424,14270,0.03,0.97,
Philippine Red Cross - Port Area,2020-06-26,444,354,50,304,0,0,1000,0,15439,15048,474,14574,0.03,0.97,
Philippine Red Cross - Port Area,2020-06-27,,,,,,,,,15439,15048,474,14574,0.03,0.97,
Philippine Red Cross Logistics & Multipurpose Center,2020-04-25,177,177,8,169,,,0,,177,177,8,169,0.05,0.95,
Philippine Red Cross Logistics & Multipurpose Center,2020-04-26,90,90,6,84,,,0,,267,267,14,253,0.05,0.95,
Philippine Red Cross Logistics & Multipurpose Center,2020-04-27,90,90,2,88,,,0,,357,357,16,341,0.04,0.96,
Philippine Red Cross Logistics & Multipurpose Center,2020-04-28,258,258,25,233,,,0,,615,615,41,574,0.07,0.93,
Philippine Red Cross Logistics & Multipurpose Center,2020-04-29,983,983,42,941,,,0,,1598,1598,83,1515,0.05,0.95,
Philippine Red Cross Logistics & Multipurpose Center,2020-04-30,268,268,17,251,,,0,,1866,1866,100,1766,0.05,0.95,
Philippine Red Cross Logistics & Multipurpose Center,2020-05-01,180,180,9,171,,,0,,2046,2046,109,1937,0.05,0.95,
Philippine Red Cross Logistics & Multipurpose Center,2020-05-02,701,701,64,637,,,0,,2747,2747,173,2574,0.06,0.94,
Philippine Red Cross Logistics & Multipurpose Center,2020-05-03,407,407,19,388,,,0,,3154,3154,192,2962,0.06,0.94,
Philippine Red Cross Logistics & Multipurpose Center,2020-05-04,540,539,23,516,,,0,,3694,3693,215,3478,0.06,0.94,
Philippine Red Cross Logistics & Multipurpose Center,2020-05-05,1169,1169,77,1092,,,0,,4863,4862,292,4570,0.06,0.94,
Philippine Red Cross Logistics & Multipurpose Center,2020-05-06,1344,1344,27,1317,,,0,,6207,6206,319,5887,0.05,0.95,
Philippine Red Cross Logistics & Multipurpose Center,2020-05-07,810,810,46,764,,,0,,7017,7016,365,6651,0.05,0.95,
Philippine Red Cross Logistics & Multipurpose Center,2020-05-08,1080,1080,46,1034,,,0,,8097,8096,411,7685,0.05,0.95,
Philippine Red Cross Logistics & Multipurpose Center,2020-05-09,810,810,43,767,,,0,,8907,8906,454,8452,0.05,0.95,
Philippine Red Cross Logistics & Multipurpose Center,2020-05-10,2340,2340,32,2308,,,0,,11247,11246,486,10760,0.04,0.96,
Philippine Red Cross Logistics & Multipurpose Center,2020-05-11,1710,1710,22,1688,,,0,,12957,12956,508,12448,0.04,0.96,
Philippine Red Cross Logistics & Multipurpose Center,2020-05-12,2158,2158,30,2128,,,,,15115,15114,538,14576,0.04,0.96,
Philippine Red Cross Logistics & Multipurpose Center,2020-05-13,1705,1705,6,1699,,,0,,16820,16819,544,16275,0.03,0.97,
Philippine Red Cross Logistics & Multipurpose Center,2020-05-14,2610,2610,73,2537,,,70000,,19430,19429,617,18812,0.03,0.97,
Philippine Red Cross Logistics & Multipurpose Center,2020-05-15,2250,2250,27,2223,,,,,21680,21679,644,21035,0.03,0.97,
Philippine Red Cross Logistics & Multipurpose Center,2020-05-16,1976,1976,17,1959,0,0,,,23656,23655,661,22994,0.03,0.97,
Philippine Red Cross Logistics & Multipurpose Center,2020-05-17,3150,3148,51,3097,0,0,60000,,26806,26803,712,26091,0.03,0.97,
Philippine Red Cross Logistics & Multipurpose Center,2020-05-18,630,540,12,528,0,0,60000,,27436,27343,724,26619,0.03,0.97,
Philippine Red Cross Logistics & Multipurpose Center,2020-05-19,540,540,14,526,0,0,60000,0,27976,27883,738,27145,0.03,0.97,
Philippine Red Cross Logistics & Multipurpose Center,2020-05-20,1170,1164,29,1135,0,0,60000,0,29146,29047,767,28280,0.03,0.97,
Philippine Red Cross Logistics & Multipurpose Center,2020-05-21,1020,1020,5,1015,0,0,50000,0,30166,30067,772,29295,0.03,0.97,
Philippine Red Cross Logistics & Multipurpose Center,2020-05-22,810,810,16,794,0,0,50000,0,30976,30877,788,30089,0.03,0.97,
Philippine Red Cross Logistics & Multipurpose Center,2020-05-23,720,689,51,638,0,0,50000,0,31696,31566,839,30727,0.03,0.97,
Philippine Red Cross Logistics & Multipurpose Center,2020-05-24,450,428,94,334,0,0,50000,0,32146,31994,933,31061,0.03,0.97,
Philippine Red Cross Logistics & Multipurpose Center,2020-05-25,,,,,,,,,32146,31994,933,31061,0.03,0.97,
Philippine Red Cross Logistics & Multipurpose Center,2020-05-26,630,630,26,604,0,0,50000,0,32776,32624,959,31665,0.03,0.97,
Philippine Red Cross Logistics & Multipurpose Center,2020-05-27,990,986,25,961,0,0,50000,0,33766,33610,984,32626,0.03,0.97,
Philippine Red Cross Logistics & Multipurpose Center,2020-05-28,1620,1159,155,1004,0,0,50000,0,35386,34769,1139,33630,0.03,0.97,
Philippine Red Cross Logistics & Multipurpose Center,2020-05-29,,,,,,,,,35386,34769,1139,33630,0.03,0.97,
Philippine Red Cross Logistics & Multipurpose Center,2020-05-30,1260,1243,78,1165,0,0,50000,0,36646,36012,1217,34795,0.03,0.97,
Philippine Red Cross Logistics & Multipurpose Center,2020-05-31,1440,1281,38,1243,0,0,50000,0,38086,37293,1255,36038,0.03,0.97,
Philippine Red Cross Logistics & Multipurpose Center,2020-06-01,1170,1128,79,1049,0,0,50000,0,39256,38421,1334,37087,0.03,0.97,
Philippine Red Cross Logistics & Multipurpose Center,2020-06-02,1080,986,45,941,0,0,50000,0,40336,39407,1379,38028,0.03,0.97,
Philippine Red Cross Logistics & Multipurpose Center,2020-06-03,1701,1686,86,1600,0,0,50000,0,42037,41093,1465,39628,0.04,0.96,
Philippine Red Cross Logistics & Multipurpose Center,2020-06-04,990,987,25,962,0,0,50000,0,43027,42080,1490,40590,0.04,0.96,
Philippine Red Cross Logistics & Multipurpose Center,2020-06-05,2520,2236,27,2209,0,0,40000,0,45547,44316,1517,42799,0.03,0.97,
Philippine Red Cross Logistics & Multipurpose Center,2020-06-06,1350,1349,171,1178,0,0,40000,0,46897,45665,1688,43977,0.04,0.96,
Philippine Red Cross Logistics & Multipurpose Center,2020-06-07,2070,2057,162,1895,0,0,40000,0,48967,47722,1850,45872,0.04,0.96,
Philippine Red Cross Logistics & Multipurpose Center,2020-06-08,1800,1781,40,1741,0,0,40000,0,50767,49503,1890,47613,0.04,0.96,
Philippine Red Cross Logistics & Multipurpose Center,2020-06-09,890,863,50,813,0,0,40000,0,51657,50366,1940,48426,0.04,0.96,
Philippine Red Cross Logistics & Multipurpose Center,2020-06-10,391,354,2,352,0,0,40000,0,52048,50720,1942,48778,0.04,0.96,
Philippine Red Cross Logistics & Multipurpose Center,2020-06-11,1530,1437,17,1420,0,0,40000,0,53578,52157,1959,50198,0.04,0.96,
Philippine Red Cross Logistics & Multipurpose Center,2020-06-12,1710,1693,59,1634,0,8,40000,0,55288,53850,2018,51832,0.04,0.96,
Philippine Red Cross Logistics & Multipurpose Center,2020-06-13,2160,2157,19,2138,0,0,40000,0,57448,56007,2037,53970,0.04,0.96,
Philippine Red Cross Logistics & Multipurpose Center,2020-06-14,2070,2055,15,2040,0,1,40000,0,59518,58062,2052,56010,0.04,0.96,
Philippine Red Cross Logistics & Multipurpose Center,2020-06-15,0,0,0,0,0,0,40000,0,59518,58062,2052,56010,0.04,0.96,
Philippine Red Cross Logistics & Multipurpose Center,2020-06-16,0,0,0,0,0,0,40000,0,59518,58062,2052,56010,0.04,0.96,
Philippine Red Cross Logistics & Multipurpose Center,2020-06-17,2340,2332,92,2240,0,0,40000,0,61858,60394,2144,58250,0.04,0.96,
Philippine Red Cross Logistics & Multipurpose Center,2020-06-18,810,809,4,805,0,0,30000,0,62668,61203,2148,59055,0.04,0.96,
Philippine Red Cross Logistics & Multipurpose Center,2020-06-19,2790,2778,84,2694,0,0,30000,0,65458,63981,2232,61749,0.03,0.97,
Philippine Red Cross Logistics & Multipurpose Center,2020-06-20,2520,2466,286,2180,0,0,44000,0,67978,66447,2518,63929,0.04,0.96,
Philippine Red Cross Logistics & Multipurpose Center,2020-06-21,2160,2146,90,2056,0,0,30000,0,70138,68593,2608,65985,0.04,0.96,
Philippine Red Cross Logistics & Multipurpose Center,2020-06-22,2068,2064,54,2010,0,0,30000,0,72206,70657,2662,67995,0.04,0.96,
Philippine Red Cross Logistics & Multipurpose Center,2020-06-23,2069,2067,64,2003,0,0,30000,0,74275,72724,2726,69998,0.04,0.96,
Philippine Red Cross Logistics & Multipurpose Center,2020-06-24,989,988,27,961,0,0,25000,0,75264,73712,2753,70959,0.04,0.96,
Philippine Red Cross Logistics & Multipurpose Center,2020-06-25,2070,2048,25,2023,0,0,25000,0,77334,75760,2778,72982,0.04,0.96,
Philippine Red Cross Logistics & Multipurpose Center,2020-06-26,1890,1879,54,1825,0,0,30000,0,79224,77639,2832,74807,0.04,0.96,
Philippine Red Cross Logistics & Multipurpose Center,2020-06-27,,,,,,,,,79224,77639,2832,74807,0.04,0.96,
Prime Care Alpha Covid-19 Testing Laboratory,2020-06-22,724,724,1,723,0,0,3466,0,724,724,1,723,0.0,1.0,
Prime Care Alpha Covid-19 Testing Laboratory,2020-06-23,,,,,,,,,724,724,1,723,0.0,1.0,
Prime Care Alpha Covid-19 Testing Laboratory,2020-06-24,,,,,,,,,724,724,1,723,0.0,1.0,
Prime Care Alpha Covid-19 Testing Laboratory,2020-06-25,,,,,,,,,724,724,1,723,0.0,1.0,
Prime Care Alpha Covid-19 Testing Laboratory,2020-06-26,,,,,,,,,724,724,1,723,0.0,1.0,
Prime Care Alpha Covid-19 Testing Laboratory,2020-06-27,,,,,,,,,724,724,1,723,0.0,1.0,
Region 1 Medical Center GeneXpert Laboratory,2020-06-10,32,32,0,32,0,2,865,0,32,32,0,32,0.0,1.0,
Region 1 Medical Center GeneXpert Laboratory,2020-06-11,32,32,0,32,0,0,833,0,64,64,0,64,0.0,1.0,
Region 1 Medical Center GeneXpert Laboratory,2020-06-12,32,32,0,32,0,0,801,0,96,96,0,96,0.0,1.0,
Region 1 Medical Center GeneXpert Laboratory,2020-06-13,32,32,0,32,0,0,769,0,128,128,0,128,0.0,1.0,
Region 1 Medical Center GeneXpert Laboratory,2020-06-14,24,24,0,24,0,0,744,0,152,152,0,152,0.0,1.0,
Region 1 Medical Center GeneXpert Laboratory,2020-06-15,19,19,0,19,0,0,726,0,171,171,0,171,0.0,1.0,
Region 1 Medical Center GeneXpert Laboratory,2020-06-16,32,32,0,32,0,0,693,0,203,203,0,203,0.0,1.0,
Region 1 Medical Center GeneXpert Laboratory,2020-06-17,32,32,0,32,0,0,661,0,235,235,0,235,0.0,1.0,
Region 1 Medical Center GeneXpert Laboratory,2020-06-18,32,32,0,32,0,0,629,41,267,267,0,267,0.0,1.0,
Region 1 Medical Center GeneXpert Laboratory,2020-06-19,32,32,0,32,0,0,597,56,299,299,0,299,0.0,1.0,
Region 1 Medical Center GeneXpert Laboratory,2020-06-20,32,32,0,32,0,0,564,20,331,331,0,331,0.0,1.0,
Region 1 Medical Center GeneXpert Laboratory,2020-06-21,32,32,0,32,0,0,532,34,363,363,0,363,0.0,1.0,
Region 1 Medical Center GeneXpert Laboratory,2020-06-22,32,32,0,32,0,0,500,40,395,395,0,395,0.0,1.0,
Region 1 Medical Center GeneXpert Laboratory,2020-06-23,32,32,1,31,0,0,468,27,427,427,1,426,0.0,1.0,
Region 1 Medical Center GeneXpert Laboratory,2020-06-24,32,32,1,31,0,0,436,38,459,459,2,457,0.0,1.0,
Region 1 Medical Center GeneXpert Laboratory,2020-06-25,36,36,1,35,0,0,400,27,495,495,3,492,0.01,0.99,
Region 1 Medical Center GeneXpert Laboratory,2020-06-26,36,36,0,36,0,0,364,34,531,531,3,528,0.01,0.99,
Region 1 Medical Center GeneXpert Laboratory,2020-06-27,,,,,,,,,531,531,3,528,0.01,0.99,
Research Institute for Tropical Medicine (RITM),2020-04-03,1641,1641,481,1160,,,56200,,20837,16806,3133,13673,0.19,0.81,
Research Institute for Tropical Medicine (RITM),2020-04-04,1810,1810,559,1251,,,53800,,22647,18616,3692,14924,0.2,0.8,
Research Institute for Tropical Medicine (RITM),2020-04-05,80,0,0,0,,,53800,,22727,18616,3692,14924,0.2,0.8,
Research Institute for Tropical Medicine (RITM),2020-04-06,1295,1295,144,1151,,,53680,,24022,19911,3836,16075,0.19,0.81,
Research Institute for Tropical Medicine (RITM),2020-04-07,751,745,45,700,,,50776,,24773,20656,3881,16775,0.19,0.81,
Research Institute for Tropical Medicine (RITM),2020-04-08,2335,2334,165,2169,,,42952,,27108,22990,4046,18944,0.18,0.82,
Research Institute for Tropical Medicine (RITM),2020-04-09,952,952,146,806,,,40664,,28060,23942,4192,19750,0.18,0.82,
Research Institute for Tropical Medicine (RITM),2020-04-10,860,860,130,730,,,40664,,28920,24802,4322,20480,0.17,0.83,
Research Institute for Tropical Medicine (RITM),2020-04-11,570,570,83,487,,,35664,,29490,25372,4405,20967,0.17,0.83,
Research Institute for Tropical Medicine (RITM),2020-04-12,1360,1140,226,914,,,35664,,30850,26512,4631,21881,0.17,0.83,
Research Institute for Tropical Medicine (RITM),2020-04-13,2226,1933,367,1566,,,50664,,33076,28445,4998,23447,0.18,0.82,
Research Institute for Tropical Medicine (RITM),2020-04-14,834,785,95,690,,,50664,,33910,29230,5093,24137,0.17,0.83,
Research Institute for Tropical Medicine (RITM),2020-04-15,1622,1372,305,1067,,,45864,,35532,30602,5398,25204,0.18,0.82,
Research Institute for Tropical Medicine (RITM),2020-04-16,1387,1213,161,1052,,,40848,,36919,31815,5559,26256,0.17,0.83,
Research Institute for Tropical Medicine (RITM),2020-04-17,1164,995,213,782,,,31648,,38083,32810,5772,27038,0.18,0.82,
Research Institute for Tropical Medicine (RITM),2020-04-18,1247,1035,178,857,,,31648,,39330,33845,5950,27895,0.18,0.82,
Research Institute for Tropical Medicine (RITM),2020-04-19,654,472,18,454,,,31648,,39984,34317,5968,28349,0.17,0.83,
Research Institute for Tropical Medicine (RITM),2020-04-20,644,499,27,472,,,28552,,40628,34816,5995,28821,0.17,0.83,
Research Institute for Tropical Medicine (RITM),2020-04-21,805,640,0,640,,,18784,,41433,35456,5995,29461,0.17,0.83,
Research Institute for Tropical Medicine (RITM),2020-04-22,1157,1039,339,700,,,20944,,42590,36495,6334,30161,0.17,0.83,
Research Institute for Tropical Medicine (RITM),2020-04-23,1120,929,25,904,,,18944,,43710,37424,6359,31065,0.17,0.83,
Research Institute for Tropical Medicine (RITM),2020-04-24,691,576,16,560,,,13144,,44401,38000,6375,31625,0.17,0.83,
Research Institute for Tropical Medicine (RITM),2020-04-25,1418,1275,104,1171,,,48144,,45819,39275,6479,32796,0.16,0.84,
Research Institute for Tropical Medicine (RITM),2020-04-26,1344,1180,91,1089,,,48144,,47163,40455,6570,33885,0.16,0.84,
Research Institute for Tropical Medicine (RITM),2020-04-27,1575,1388,129,1259,,,47280,,48738,41843,6699,35144,0.16,0.84,
Research Institute for Tropical Medicine (RITM),2020-04-28,1104,849,37,812,,,47280,,49842,42692,6736,35956,0.16,0.84,
Research Institute for Tropical Medicine (RITM),2020-04-29,1349,954,18,936,,,45600,,51191,43646,6754,36892,0.15,0.85,
Research Institute for Tropical Medicine (RITM),2020-04-30,943,571,6,565,,,1480,,52134,44217,6760,37457,0.15,0.85,
Research Institute for Tropical Medicine (RITM),2020-05-01,913,633,2,631,,,480,,53047,44850,6762,38088,0.15,0.85,
Research Institute for Tropical Medicine (RITM),2020-05-02,1467,1211,54,1157,,,93288,,54514,46061,6816,39245,0.15,0.85,
Research Institute for Tropical Medicine (RITM),2020-05-03,1274,1106,71,1035,,,192096,,55788,47167,6887,40280,0.15,0.85,
Research Institute for Tropical Medicine (RITM),2020-05-04,1135,1006,99,907,,,190296,,56923,48173,6986,41187,0.15,0.85,
Research Institute for Tropical Medicine (RITM),2020-05-05,1306,1167,48,1119,,,89088,,58229,49340,7034,42306,0.14,0.86,
Research Institute for Tropical Medicine (RITM),2020-05-06,575,467,56,411,,,88488,,58804,49807,7090,42717,0.14,0.86,
Research Institute for Tropical Medicine (RITM),2020-05-07,537,406,4,402,,,76488,,59341,50213,7094,43119,0.14,0.86,
Research Institute for Tropical Medicine (RITM),2020-05-08,141,123,6,117,,,52488,,59482,50336,7100,43236,0.14,0.86,
Research Institute for Tropical Medicine (RITM),2020-05-09,1161,1020,56,964,,,592788,,60643,51356,7156,44200,0.14,0.86,
Research Institute for Tropical Medicine (RITM),2020-05-10,1463,1326,55,1271,,,610528,,62106,52682,7211,45471,0.14,0.86,
Research Institute for Tropical Medicine (RITM),2020-05-11,1202,1104,63,1041,,,606928,,63308,53786,7274,46512,0.14,0.86,
Research Institute for Tropical Medicine (RITM),2020-05-12,973,916,33,883,,,591848,,64281,54702,7307,47395,0.13,0.87,
Research Institute for Tropical Medicine (RITM),2020-05-13,2303,2097,129,1968,,,591848,,66584,56799,7436,49363,0.13,0.87,
Research Institute for Tropical Medicine (RITM),2020-05-14,1785,1655,61,1594,,,591848,,68369,58454,7497,50957,0.13,0.87,
Research Institute for Tropical Medicine (RITM),2020-05-15,1662,1506,85,1421,,,585848,,70031,59960,7582,52378,0.13,0.87,
Research Institute for Tropical Medicine (RITM),2020-05-16,1618,1454,71,1383,0,0,,,71649,61414,7653,53761,0.12,0.88,
Research Institute for Tropical Medicine (RITM),2020-05-17,1071,988,50,938,0,0,585848,,72720,62402,7703,54699,0.12,0.88,
Research Institute for Tropical Medicine (RITM),2020-05-18,772,698,13,685,0,0,575848,,73492,63100,7716,55384,0.12,0.88,
Research Institute for Tropical Medicine (RITM),2020-05-19,824,665,19,646,0,1,575848,2300,74316,63765,7735,56030,0.12,0.88,
Research Institute for Tropical Medicine (RITM),2020-05-20,937,869,38,831,0,0,588328,1671,75253,64634,7773,56861,0.12,0.88,
Research Institute for Tropical Medicine (RITM),2020-05-21,1977,1796,73,1723,0,1,623368,901,77230,66430,7846,58584,0.12,0.88,
Research Institute for Tropical Medicine (RITM),2020-05-22,1760,1615,73,1542,0,1,623368,1231,78990,68045,7919,60126,0.12,0.88,
Research Institute for Tropical Medicine (RITM),2020-05-23,1722,1601,50,1551,0,1,623368,1143,80712,69646,7969,61677,0.11,0.89,
Research Institute for Tropical Medicine (RITM),2020-05-24,942,832,56,776,0,0,623368,1740,81654,70478,8025,62453,0.11,0.89,
Research Institute for Tropical Medicine (RITM),2020-05-25,831,758,30,728,0,1,546924,2619,82485,71236,8055,63181,0.11,0.89,
Research Institute for Tropical Medicine (RITM),2020-05-26,1665,1491,54,1437,0,0,545124,2399,84150,72727,8109,64618,0.11,0.89,
Research Institute for Tropical Medicine (RITM),2020-05-27,1318,1084,68,1016,0,0,540036,2343,85468,73811,8177,65634,0.11,0.89,
Research Institute for Tropical Medicine (RITM),2020-05-28,1534,1443,24,1419,0,1,457092,1156,87002,75254,8201,67053,0.11,0.89,
Research Institute for Tropical Medicine (RITM),2020-05-29,2313,2062,74,1988,0,0,457092,353,89315,77316,8275,69041,0.11,0.89,
Research Institute for Tropical Medicine (RITM),2020-05-30,1525,1417,71,1346,0,0,457092,344,90840,78733,8346,70387,0.11,0.89,
Research Institute for Tropical Medicine (RITM),2020-05-31,1597,1427,71,1356,0,1,457092,550,92437,80160,8417,71743,0.11,0.89,
Research Institute for Tropical Medicine (RITM),2020-06-01,970,875,45,830,0,0,457092,1515,93407,81035,8462,72573,0.1,0.9,
Research Institute for Tropical Medicine (RITM),2020-06-02,2458,2321,53,2268,0,0,457092,1305,95865,83356,8515,74841,0.1,0.9,
Research Institute for Tropical Medicine (RITM),2020-06-03,1848,1739,64,1675,0,0,422892,355,97713,85095,8579,76516,0.1,0.9,
Research Institute for Tropical Medicine (RITM),2020-06-04,2372,2231,60,2171,0,0,412892,166,100085,87326,8639,78687,0.1,0.9,
Research Institute for Tropical Medicine (RITM),2020-06-05,1598,1427,61,1366,0,0,406892,307,101683,88753,8700,80053,0.1,0.9,
Research Institute for Tropical Medicine (RITM),2020-06-06,1651,1455,72,1383,0,0,404892,433,103334,90208,8772,81436,0.1,0.9,
Research Institute for Tropical Medicine (RITM),2020-06-07,1517,1378,70,1308,0,0,451492,633,104851,91586,8842,82744,0.1,0.9,
Research Institute for Tropical Medicine (RITM),2020-06-08,1228,1149,39,1110,0,0,451492,793,106079,92735,8881,83854,0.1,0.9,
Research Institute for Tropical Medicine (RITM),2020-06-09,1709,1468,62,1406,0,0,411492,209,107788,94203,8943,85260,0.09,0.91,
Research Institute for Tropical Medicine (RITM),2020-06-10,1178,971,63,908,0,0,399492,135,108966,95174,9006,86168,0.09,0.91,
Research Institute for Tropical Medicine (RITM),2020-06-11,1216,1080,76,1004,0,0,319492,258,110182,96254,9082,87172,0.09,0.91,
Research Institute for Tropical Medicine (RITM),2020-06-12,2111,1918,66,1852,0,0,319492,497,112293,98172,9148,89024,0.09,0.91,
Research Institute for Tropical Medicine (RITM),2020-06-13,1524,1345,61,1284,0,0,319492,952,113817,99517,9209,90308,0.09,0.91,
Research Institute for Tropical Medicine (RITM),2020-06-14,2129,1854,77,1777,0,0,319492,725,115946,101371,9286,92085,0.09,0.91,
Research Institute for Tropical Medicine (RITM),2020-06-15,1429,1242,55,1187,0,1,293492,411,117375,102613,9341,93272,0.09,0.91,
Research Institute for Tropical Medicine (RITM),2020-06-16,1206,940,77,863,0,0,366908,145,118581,103553,9418,94135,0.09,0.91,
Research Institute for Tropical Medicine (RITM),2020-06-17,1206,940,77,863,0,0,366908,145,119787,104493,9495,94998,0.09,0.91,
Research Institute for Tropical Medicine (RITM),2020-06-18,1095,914,48,866,0,0,366908,367,120882,105407,9543,95864,0.09,0.91,
Research Institute for Tropical Medicine (RITM),2020-06-19,1801,1532,98,1434,0,1,374108,209,122683,106939,9641,97298,0.09,0.91,
Research Institute for Tropical Medicine (RITM),2020-06-20,1391,1195,88,1107,0,0,374108,283,124074,108134,9729,98405,0.09,0.91,
Research Institute for Tropical Medicine (RITM),2020-06-21,1914,1738,60,1678,0,0,355964,230,125988,109872,9789,100083,0.09,0.91,
Research Institute for Tropical Medicine (RITM),2020-06-22,1161,976,86,890,0,0,355964,210,127149,110848,9875,100973,0.09,0.91,
Research Institute for Tropical Medicine (RITM),2020-06-23,947,713,47,666,0,0,355964,104,128096,111561,9922,101639,0.09,0.91,
Research Institute for Tropical Medicine (RITM),2020-06-24,1161,969,98,871,0,0,337964,89,129257,112530,10020,102510,0.09,0.91,
Research Institute for Tropical Medicine (RITM),2020-06-25,1307,1093,99,994,0,0,332964,438,130564,113623,10119,103504,0.09,0.91,
Research Institute for Tropical Medicine (RITM),2020-06-26,1718,1466,163,1303,0,0,342964,403,132282,115089,10282,104807,0.09,0.91,
Research Institute for Tropical Medicine (RITM),2020-06-27,1348,1142,189,953,0,0,232964,875,133630,116231,10471,105760,0.09,0.91,
"Safeguard DNA Diagnostics, Inc",2020-06-10,71,71,0,71,0,0,11400,0,71,71,0,71,0.0,1.0,
"Safeguard DNA Diagnostics, Inc",2020-06-11,,,,,,,,,71,71,0,71,0.0,1.0,
"Safeguard DNA Diagnostics, Inc",2020-06-12,,,,,,,,,71,71,0,71,0.0,1.0,
"Safeguard DNA Diagnostics, Inc",2020-06-13,,,,,,,,,71,71,0,71,0.0,1.0,
"Safeguard DNA Diagnostics, Inc",2020-06-14,,,,,,,,,71,71,0,71,0.0,1.0,
"Safeguard DNA Diagnostics, Inc",2020-06-15,,,,,,,,,71,71,0,71,0.0,1.0,
"Safeguard DNA Diagnostics, Inc",2020-06-16,219,219,0,219,0,0,10201,0,290,290,0,290,0.0,1.0,
"Safeguard DNA Diagnostics, Inc",2020-06-17,75,75,1,74,0,0,10126,0,365,365,1,364,0.0,1.0,
"Safeguard DNA Diagnostics, Inc",2020-06-18,195,195,2,193,0,0,9931,0,560,560,3,557,0.01,0.99,
"Safeguard DNA Diagnostics, Inc",2020-06-19,,,,,,,,,560,560,3,557,0.01,0.99,
"Safeguard DNA Diagnostics, Inc",2020-06-20,,,,,,,,,560,560,3,557,0.01,0.99,
"Safeguard DNA Diagnostics, Inc",2020-06-21,,,,,,,,,560,560,3,557,0.01,0.99,
"Safeguard DNA Diagnostics, Inc",2020-06-22,78,78,4,74,0,0,10000,0,638,638,7,631,0.01,0.99,
"Safeguard DNA Diagnostics, Inc",2020-06-23,,,,,,,,,638,638,7,631,0.01,0.99,
"Safeguard DNA Diagnostics, Inc",2020-06-24,,,,,,,,,638,638,7,631,0.01,0.99,
"Safeguard DNA Diagnostics, Inc",2020-06-25,,,,,,,,,638,638,7,631,0.01,0.99,
"Safeguard DNA Diagnostics, Inc",2020-06-26,,,,,,,,,638,638,7,631,0.01,0.99,
"Safeguard DNA Diagnostics, Inc",2020-06-27,,,,,,,,,638,638,7,631,0.01,0.99,
San Lazaro Hospital (SLH),2020-04-03,28,9,6,3,,,4846,,221,124,37,87,0.3,0.7,
San Lazaro Hospital (SLH),2020-04-04,0,0,0,0,,,4846,,221,124,37,87,0.3,0.7,
San Lazaro Hospital (SLH),2020-04-05,0,0,0,0,,,4846,,221,124,37,87,0.3,0.7,
San Lazaro Hospital (SLH),2020-04-06,52,35,5,30,,,4765,,273,159,42,117,0.26,0.74,
San Lazaro Hospital (SLH),2020-04-07,36,33,6,27,,,4725,,309,192,48,144,0.25,0.75,
San Lazaro Hospital (SLH),2020-04-08,46,43,2,41,,,4636,,355,235,50,185,0.21,0.79,
San Lazaro Hospital (SLH),2020-04-09,80,80,7,73,,,4571,,435,315,57,258,0.18,0.82,
San Lazaro Hospital (SLH),2020-04-10,0,0,0,0,,,4571,,435,315,57,258,0.18,0.82,
San Lazaro Hospital (SLH),2020-04-11,0,0,0,0,,,4571,,435,315,57,258,0.18,0.82,
San Lazaro Hospital (SLH),2020-04-12,0,0,0,0,,,4571,,435,315,57,258,0.18,0.82,
San Lazaro Hospital (SLH),2020-04-13,45,43,6,37,,,4522,,480,358,63,295,0.18,0.82,
San Lazaro Hospital (SLH),2020-04-14,30,30,5,25,,,4488,,510,388,68,320,0.18,0.82,
San Lazaro Hospital (SLH),2020-04-15,91,91,21,70,,,4389,,601,479,89,390,0.19,0.81,
San Lazaro Hospital (SLH),2020-04-16,124,124,14,110,,,4257,,725,603,103,500,0.17,0.83,
San Lazaro Hospital (SLH),2020-04-17,91,73,3,70,,,4154,,816,676,106,570,0.16,0.84,
San Lazaro Hospital (SLH),2020-04-18,288,227,11,216,,,3851,,1104,903,117,786,0.13,0.87,
San Lazaro Hospital (SLH),2020-04-19,215,215,12,203,,,3627,,1319,1118,129,989,0.12,0.88,
San Lazaro Hospital (SLH),2020-04-20,183,183,1,182,,,3436,,1502,1301,130,1171,0.1,0.9,
San Lazaro Hospital (SLH),2020-04-21,128,128,6,122,,,3100,,1630,1429,136,1293,0.1,0.9,
San Lazaro Hospital (SLH),2020-04-22,299,299,8,291,,,2785,,1929,1728,144,1584,0.08,0.92,
San Lazaro Hospital (SLH),2020-04-23,274,274,14,260,,,2489,,2203,2002,158,1844,0.08,0.92,
San Lazaro Hospital (SLH),2020-04-24,238,229,4,225,,,2235,,2441,2231,162,2069,0.07,0.93,
San Lazaro Hospital (SLH),2020-04-25,236,235,7,228,,,1889,,2677,2466,169,2297,0.07,0.93,
San Lazaro Hospital (SLH),2020-04-26,186,186,13,173,,,1557,,2863,2652,182,2470,0.07,0.93,
San Lazaro Hospital (SLH),2020-04-27,316,290,16,274,,,1225,,3179,2942,198,2744,0.07,0.93,
San Lazaro Hospital (SLH),2020-04-28,245,209,16,193,,,968,,3424,3151,214,2937,0.07,0.93,
San Lazaro Hospital (SLH),2020-04-29,339,284,4,280,,,98,,3763,3435,218,3217,0.06,0.94,
San Lazaro Hospital (SLH),2020-04-30,316,303,4,299,,,0,,4079,3738,222,3516,0.06,0.94,
San Lazaro Hospital (SLH),2020-05-01,212,186,9,177,,,1620,,4291,3924,231,3693,0.06,0.94,
San Lazaro Hospital (SLH),2020-05-02,342,302,8,294,,,1260,,4633,4226,239,3987,0.06,0.94,
San Lazaro Hospital (SLH),2020-05-03,261,256,3,253,,,993,,4894,4482,242,4240,0.05,0.95,
San Lazaro Hospital (SLH),2020-05-04,498,429,17,412,,,420,,5392,4911,259,4652,0.05,0.95,
San Lazaro Hospital (SLH),2020-05-05,465,462,4,458,,,0,,5857,5373,263,5110,0.05,0.95,
San Lazaro Hospital (SLH),2020-05-06,372,361,7,354,,,0,,6229,5734,270,5464,0.05,0.95,
San Lazaro Hospital (SLH),2020-05-07,184,184,0,184,,,5000,,6413,5918,270,5648,0.05,0.95,
San Lazaro Hospital (SLH),2020-05-08,465,465,0,465,,,4139,,6878,6383,270,6113,0.04,0.96,
San Lazaro Hospital (SLH),2020-05-09,373,354,9,345,,,3740,,7251,6737,279,6458,0.04,0.96,
San Lazaro Hospital (SLH),2020-05-10,315,281,6,275,,,3480,,7566,7018,285,6733,0.04,0.96,
San Lazaro Hospital (SLH),2020-05-11,372,289,9,280,,,3240,,7938,7307,294,7013,0.04,0.96,
San Lazaro Hospital (SLH),2020-05-12,343,286,10,276,,,3060,,8281,7593,304,7289,0.04,0.96,
San Lazaro Hospital (SLH),2020-05-13,334,316,26,290,,,2880,,8615,7909,330,7579,0.04,0.96,
San Lazaro Hospital (SLH),2020-05-14,187,150,11,139,,,2540,,8802,8059,341,7718,0.04,0.96,
San Lazaro Hospital (SLH),2020-05-15,339,307,11,296,,,2280,,9141,8366,352,8014,0.04,0.96,
San Lazaro Hospital (SLH),2020-05-16,336,250,4,246,0,0,2100,,9477,8616,356,8260,0.04,0.96,
San Lazaro Hospital (SLH),2020-05-17,180,138,9,129,0,0,1880,,9657,8754,365,8389,0.04,0.96,
San Lazaro Hospital (SLH),2020-05-18,139,108,7,101,0,0,1760,,9796,8862,372,8490,0.04,0.96,
San Lazaro Hospital (SLH),2020-05-19,229,174,8,166,0,0,1540,35,10025,9036,380,8656,0.04,0.96,
San Lazaro Hospital (SLH),2020-05-20,239,162,5,157,0,0,1340,0,10264,9198,385,8813,0.04,0.96,
San Lazaro Hospital (SLH),2020-05-21,256,170,8,162,0,0,1020,0,10520,9368,393,8975,0.04,0.96,
San Lazaro Hospital (SLH),2020-05-22,227,161,18,143,0,0,860,0,10747,9529,411,9118,0.04,0.96,
San Lazaro Hospital (SLH),2020-05-23,228,131,7,124,0,0,660,0,10975,9660,418,9242,0.04,0.96,
San Lazaro Hospital (SLH),2020-05-24,255,201,5,196,0,1,480,0,11230,9861,423,9438,0.04,0.96,
San Lazaro Hospital (SLH),2020-05-25,107,47,3,44,0,0,340,0,11337,9908,426,9482,0.04,0.96,
San Lazaro Hospital (SLH),2020-05-26,163,116,2,114,0,0,10200,0,11500,10024,428,9596,0.04,0.96,
San Lazaro Hospital (SLH),2020-05-27,275,230,16,214,0,2,9960,0,11775,10254,444,9810,0.04,0.96,
San Lazaro Hospital (SLH),2020-05-28,227,177,4,173,0,0,9780,0,12002,10431,448,9983,0.04,0.96,
San Lazaro Hospital (SLH),2020-05-29,173,124,5,119,0,0,9640,0,12175,10555,453,10102,0.04,0.96,
San Lazaro Hospital (SLH),2020-05-30,192,110,3,107,0,0,9500,0,12367,10665,456,10209,0.04,0.96,
San Lazaro Hospital (SLH),2020-05-31,169,116,18,98,0,0,9340,0,12536,10781,474,10307,0.04,0.96,
San Lazaro Hospital (SLH),2020-06-01,159,145,24,121,0,0,9180,0,12695,10926,498,10428,0.05,0.95,
San Lazaro Hospital (SLH),2020-06-02,224,180,14,166,0,0,9060,0,12919,11106,512,10594,0.05,0.95,
San Lazaro Hospital (SLH),2020-06-03,273,194,27,167,0,0,8900,0,13192,11300,539,10761,0.05,0.95,
San Lazaro Hospital (SLH),2020-06-04,231,183,28,155,0,0,8740,0,13423,11483,567,10916,0.05,0.95,
San Lazaro Hospital (SLH),2020-06-05,234,179,9,170,0,0,8560,0,13657,11662,576,11086,0.05,0.95,
San Lazaro Hospital (SLH),2020-06-06,295,240,30,210,0,0,8300,0,13952,11902,606,11296,0.05,0.95,
San Lazaro Hospital (SLH),2020-06-07,99,72,9,63,0,0,8180,0,14051,11974,615,11359,0.05,0.95,
San Lazaro Hospital (SLH),2020-06-08,84,68,7,61,0,0,8140,0,14135,12042,622,11420,0.05,0.95,
San Lazaro Hospital (SLH),2020-06-09,213,155,13,142,0,0,7980,0,14348,12197,635,11562,0.05,0.95,
San Lazaro Hospital (SLH),2020-06-10,291,173,15,158,0,1,7760,0,14639,12370,650,11720,0.05,0.95,
San Lazaro Hospital (SLH),2020-06-11,301,203,22,181,0,0,7560,0,14940,12573,672,11901,0.05,0.95,
San Lazaro Hospital (SLH),2020-06-12,214,151,9,142,0,0,7400,0,15154,12724,681,12043,0.05,0.95,
San Lazaro Hospital (SLH),2020-06-13,160,81,16,65,0,0,7260,0,15314,12805,697,12108,0.05,0.95,
San Lazaro Hospital (SLH),2020-06-14,200,141,24,117,0,0,7180,0,15514,12946,721,12225,0.06,0.94,
San Lazaro Hospital (SLH),2020-06-15,139,109,8,101,0,0,7060,0,15653,13055,729,12326,0.06,0.94,
San Lazaro Hospital (SLH),2020-06-16,352,225,16,209,0,1,6820,0,16005,13280,745,12535,0.06,0.94,
San Lazaro Hospital (SLH),2020-06-17,308,233,27,206,0,0,6640,0,16313,13513,772,12741,0.06,0.94,
San Lazaro Hospital (SLH),2020-06-18,283,204,12,192,0,0,6400,0,16596,13717,784,12933,0.06,0.94,
San Lazaro Hospital (SLH),2020-06-19,261,213,24,189,0,0,6180,0,16857,13930,808,13122,0.06,0.94,
San Lazaro Hospital (SLH),2020-06-20,256,199,17,182,0,0,5980,0,17113,14129,825,13304,0.06,0.94,
San Lazaro Hospital (SLH),2020-06-21,148,123,27,96,0,0,5880,0,17261,14252,852,13400,0.06,0.94,
San Lazaro Hospital (SLH),2020-06-22,84,72,22,50,0,0,5880,0,17345,14324,874,13450,0.06,0.94,
San Lazaro Hospital (SLH),2020-06-23,245,192,23,169,0,0,5680,0,17590,14516,897,13619,0.06,0.94,
San Lazaro Hospital (SLH),2020-06-24,220,152,28,124,0,0,5520,0,17810,14668,925,13743,0.06,0.94,
San Lazaro Hospital (SLH),2020-06-25,213,160,29,131,0,0,5380,0,18023,14828,954,13874,0.06,0.94,
San Lazaro Hospital (SLH),2020-06-26,245,160,36,124,0,0,5100,0,18268,14988,990,13998,0.07,0.93,
San Lazaro Hospital (SLH),2020-06-27,312,225,53,172,0,0,4840,0,18580,15213,1043,14170,0.07,0.93,
Singapore Diagnostics,2020-05-07,80,80,7,73,,,9440,,160,80,7,73,0.09,0.91,
Singapore Diagnostics,2020-05-08,54,53,6,47,,,9390,,214,133,13,120,0.1,0.9,
Singapore Diagnostics,2020-05-09,90,90,15,75,,,9390,,304,223,28,195,0.13,0.87,
Singapore Diagnostics,2020-05-10,0,0,0,0,,,9390,,304,223,28,195,0.13,0.87,
Singapore Diagnostics,2020-05-11,29,29,3,26,,,9115,,333,252,31,221,0.12,0.88,
Singapore Diagnostics,2020-05-12,99,99,8,91,,,9069,,432,351,39,312,0.11,0.89,
Singapore Diagnostics,2020-05-13,106,97,8,89,,,8960,,538,448,47,401,0.1,0.9,
Singapore Diagnostics,2020-05-14,128,127,10,117,,,8820,,666,575,57,518,0.1,0.9,
Singapore Diagnostics,2020-05-15,180,161,19,142,,,8626,,846,736,76,660,0.1,0.9,
Singapore Diagnostics,2020-05-16,139,139,12,127,0,0,8400,,985,875,88,787,0.1,0.9,
Singapore Diagnostics,2020-05-17,134,134,37,97,0,0,7990,,1119,1009,125,884,0.12,0.88,
Singapore Diagnostics,2020-05-18,113,113,6,107,0,0,7850,,1232,1122,131,991,0.12,0.88,
Singapore Diagnostics,2020-05-19,125,124,17,107,0,1,7750,289,1357,1246,148,1098,0.12,0.88,
Singapore Diagnostics,2020-05-20,139,137,9,128,0,1,7448,6,1496,1383,157,1226,0.11,0.89,
Singapore Diagnostics,2020-05-21,93,91,6,85,0,0,7300,92,1589,1474,163,1311,0.11,0.89,
Singapore Diagnostics,2020-05-22,138,138,19,119,0,0,7100,230,1727,1612,182,1430,0.11,0.89,
Singapore Diagnostics,2020-05-23,173,173,11,162,0,0,6850,294,1900,1785,193,1592,0.11,0.89,
Singapore Diagnostics,2020-05-24,144,144,18,126,0,0,6600,320,2044,1929,211,1718,0.11,0.89,
Singapore Diagnostics,2020-05-25,180,180,7,173,0,0,5500,250,2224,2109,218,1891,0.1,0.9,
Singapore Diagnostics,2020-05-26,188,188,20,168,0,0,4000,88,2412,2297,238,2059,0.1,0.9,
Singapore Diagnostics,2020-05-27,271,270,41,229,0,1,3700,60,2683,2567,279,2288,0.11,0.89,
Singapore Diagnostics,2020-05-28,166,162,7,155,0,0,3600,41,2849,2729,286,2443,0.1,0.9,
Singapore Diagnostics,2020-05-29,290,290,19,271,0,0,3200,60,3139,3019,305,2714,0.1,0.9,
Singapore Diagnostics,2020-05-30,442,439,15,424,0,2,2400,15,3581,3458,320,3138,0.09,0.91,
Singapore Diagnostics,2020-05-31,251,244,28,216,0,6,1800,75,3832,3702,348,3354,0.09,0.91,
Singapore Diagnostics,2020-06-01,300,277,26,251,0,18,1800,0,4132,3979,374,3605,0.09,0.91,
Singapore Diagnostics,2020-06-02,218,202,11,191,0,1,1800,0,4350,4181,385,3796,0.09,0.91,
Singapore Diagnostics,2020-06-03,250,230,33,197,0,0,1000,0,4600,4411,418,3993,0.09,0.91,
Singapore Diagnostics,2020-06-04,287,285,23,262,0,2,800,0,4887,4696,441,4255,0.09,0.91,
Singapore Diagnostics,2020-06-05,146,146,27,119,0,0,800,0,5033,4842,468,4374,0.1,0.9,
Singapore Diagnostics,2020-06-06,170,168,7,161,0,0,400,0,5203,5010,475,4535,0.09,0.91,
Singapore Diagnostics,2020-06-07,178,178,42,136,0,0,400,0,5381,5188,517,4671,0.1,0.9,
Singapore Diagnostics,2020-06-08,199,199,23,176,0,0,2400,0,5580,5387,540,4847,0.1,0.9,
Singapore Diagnostics,2020-06-09,200,200,33,167,0,0,1700,0,5780,5587,573,5014,0.1,0.9,
Singapore Diagnostics,2020-06-10,260,213,21,192,0,1,1400,0,6040,5800,594,5206,0.1,0.9,
Singapore Diagnostics,2020-06-11,240,197,23,174,0,0,1150,0,6280,5997,617,5380,0.1,0.9,
Singapore Diagnostics,2020-06-12,198,176,20,156,0,1,950,0,6478,6173,637,5536,0.1,0.9,
Singapore Diagnostics,2020-06-13,167,130,23,107,0,0,750,0,6645,6303,660,5643,0.1,0.9,
Singapore Diagnostics,2020-06-14,95,89,14,75,0,0,650,0,6740,6392,674,5718,0.11,0.89,
Singapore Diagnostics,2020-06-15,4,3,0,3,0,0,1300,0,6744,6395,674,5721,0.11,0.89,
Singapore Diagnostics,2020-06-16,104,91,7,84,0,0,1200,0,6848,6486,681,5805,0.1,0.9,
Singapore Diagnostics,2020-06-17,289,258,48,210,0,0,800,0,7137,6744,729,6015,0.11,0.89,
Singapore Diagnostics,2020-06-18,226,211,24,187,0,0,800,0,7363,6955,753,6202,0.11,0.89,
Singapore Diagnostics,2020-06-19,184,157,35,122,0,0,700,0,7547,7112,788,6324,0.11,0.89,
Singapore Diagnostics,2020-06-20,165,150,18,132,0,0,500,0,7712,7262,806,6456,0.11,0.89,
Singapore Diagnostics,2020-06-21,117,99,6,93,0,2,300,0,7829,7361,812,6549,0.11,0.89,
Singapore Diagnostics,2020-06-22,123,112,21,91,0,0,100,0,7952,7473,833,6640,0.11,0.89,
Singapore Diagnostics,2020-06-23,275,242,54,188,0,1,1920,0,8227,7715,887,6828,0.11,0.89,
Singapore Diagnostics,2020-06-24,151,119,32,87,0,2,1760,0,8378,7834,919,6915,0.12,0.88,
Singapore Diagnostics,2020-06-25,118,97,38,59,0,0,1632,0,8496,7931,957,6974,0.12,0.88,
Singapore Diagnostics,2020-06-26,,,,,,,,,8496,7931,957,6974,0.12,0.88,
Singapore Diagnostics,2020-06-27,,,,,,,,,8496,7931,957,6974,0.12,0.88,
Southern Philippines Medical Center (SPMC),2020-04-03,237,237,7,230,,,3941,,958,958,74,884,0.08,0.92,
Southern Philippines Medical Center (SPMC),2020-04-04,151,151,5,146,,,3590,,1109,1109,79,1030,0.07,0.93,
Southern Philippines Medical Center (SPMC),2020-04-05,0,0,0,0,,,3416,,1109,1109,79,1030,0.07,0.93,
Southern Philippines Medical Center (SPMC),2020-04-06,152,152,3,149,,,3226,,1261,1261,82,1179,0.07,0.93,
Southern Philippines Medical Center (SPMC),2020-04-07,364,326,15,311,,,2826,,1625,1587,97,1490,0.06,0.94,
Southern Philippines Medical Center (SPMC),2020-04-08,161,57,3,54,,,2669,,1786,1644,100,1544,0.06,0.94,
Southern Philippines Medical Center (SPMC),2020-04-09,195,179,0,179,,,2669,,1981,1823,100,1723,0.05,0.95,
Southern Philippines Medical Center (SPMC),2020-04-10,45,37,0,37,,,2560,,2026,1860,100,1760,0.05,0.95,
Southern Philippines Medical Center (SPMC),2020-04-11,58,45,3,42,,,2450,,2084,1905,103,1802,0.05,0.95,
Southern Philippines Medical Center (SPMC),2020-04-12,0,0,0,0,,,2450,,2084,1905,103,1802,0.05,0.95,
Southern Philippines Medical Center (SPMC),2020-04-13,10,7,2,5,,,2450,,2094,1912,105,1807,0.05,0.95,
Southern Philippines Medical Center (SPMC),2020-04-14,79,60,3,57,,,2337,,2173,1972,108,1864,0.05,0.95,
Southern Philippines Medical Center (SPMC),2020-04-15,97,39,2,37,,,2222,,2270,2011,110,1901,0.05,0.95,
Southern Philippines Medical Center (SPMC),2020-04-16,159,97,8,89,,,2045,,2429,2108,118,1990,0.06,0.94,
Southern Philippines Medical Center (SPMC),2020-04-17,54,46,0,46,,,1987,,2483,2154,118,2036,0.05,0.95,
Southern Philippines Medical Center (SPMC),2020-04-18,159,115,4,111,,,1803,,2642,2269,122,2147,0.05,0.95,
Southern Philippines Medical Center (SPMC),2020-04-19,39,34,3,31,,,11759,,2681,2303,125,2178,0.05,0.95,
Southern Philippines Medical Center (SPMC),2020-04-20,196,158,5,153,,,11525,,2877,2461,130,2331,0.05,0.95,
Southern Philippines Medical Center (SPMC),2020-04-21,179,121,2,119,,,11330,,3056,2582,132,2450,0.05,0.95,
Southern Philippines Medical Center (SPMC),2020-04-22,123,108,2,106,,,11194,,3179,2690,134,2556,0.05,0.95,
Southern Philippines Medical Center (SPMC),2020-04-23,210,166,1,165,,,10971,,3389,2856,135,2721,0.05,0.95,
Southern Philippines Medical Center (SPMC),2020-04-24,120,91,6,85,,,10835,,3509,2947,141,2806,0.05,0.95,
Southern Philippines Medical Center (SPMC),2020-04-25,130,95,4,91,,,10705,,3639,3042,145,2897,0.05,0.95,
Southern Philippines Medical Center (SPMC),2020-04-26,62,54,3,51,,,10639,,3701,3096,148,2948,0.05,0.95,
Southern Philippines Medical Center (SPMC),2020-04-27,218,199,3,196,,,10404,,3919,3295,151,3144,0.05,0.95,
Southern Philippines Medical Center (SPMC),2020-04-28,249,221,3,218,,,10087,,4168,3516,154,3362,0.04,0.96,
Southern Philippines Medical Center (SPMC),2020-04-29,192,152,6,146,,,9880,,4360,3668,160,3508,0.04,0.96,
Southern Philippines Medical Center (SPMC),2020-04-30,137,120,2,118,,,9733,,4497,3788,162,3626,0.04,0.96,
Southern Philippines Medical Center (SPMC),2020-05-01,224,189,6,183,,,9490,,4721,3977,168,3809,0.04,0.96,
Southern Philippines Medical Center (SPMC),2020-05-02,184,148,2,146,,,9298,,4905,4125,170,3955,0.04,0.96,
Southern Philippines Medical Center (SPMC),2020-05-03,55,49,0,49,,,9238,,4960,4174,170,4004,0.04,0.96,
Southern Philippines Medical Center (SPMC),2020-05-04,283,225,20,205,,,8918,,5243,4399,190,4209,0.04,0.96,
Southern Philippines Medical Center (SPMC),2020-05-05,249,217,4,213,,,8644,,5492,4616,194,4422,0.04,0.96,
Southern Philippines Medical Center (SPMC),2020-05-06,239,206,1,205,,,8390,,5731,4822,195,4627,0.04,0.96,
Southern Philippines Medical Center (SPMC),2020-05-07,230,182,9,173,,,8132,,5961,5004,204,4800,0.04,0.96,
Southern Philippines Medical Center (SPMC),2020-05-08,302,255,6,249,,,7808,,6263,5259,210,5049,0.04,0.96,
Southern Philippines Medical Center (SPMC),2020-05-09,265,252,0,252,,,7524,,6528,5511,210,5301,0.04,0.96,
Southern Philippines Medical Center (SPMC),2020-05-10,0,0,0,0,,,17524,,6528,5511,210,5301,0.04,0.96,
Southern Philippines Medical Center (SPMC),2020-05-11,136,94,1,93,,,18361,,6664,5605,211,5394,0.04,0.96,
Southern Philippines Medical Center (SPMC),2020-05-12,230,212,0,212,,,18116,,6894,5817,211,5606,0.04,0.96,
Southern Philippines Medical Center (SPMC),2020-05-13,240,171,12,159,,,17860,,7134,5988,223,5765,0.04,0.96,
Southern Philippines Medical Center (SPMC),2020-05-14,216,168,12,156,,,17628,,7350,6156,235,5921,0.04,0.96,
Southern Philippines Medical Center (SPMC),2020-05-15,97,61,1,60,,,17523,,7447,6217,236,5981,0.04,0.96,
Southern Philippines Medical Center (SPMC),2020-05-16,128,83,5,78,0,0,17387,,7575,6300,241,6059,0.04,0.96,
Southern Philippines Medical Center (SPMC),2020-05-17,66,58,16,42,0,0,0,,7641,6358,257,6101,0.04,0.96,
Southern Philippines Medical Center (SPMC),2020-05-18,158,86,7,79,0,0,17147,,7799,6444,264,6180,0.04,0.96,
Southern Philippines Medical Center (SPMC),2020-05-19,242,194,2,192,0,0,16887,0,8041,6638,266,6372,0.04,0.96,
Southern Philippines Medical Center (SPMC),2020-05-20,263,189,14,175,0,0,16624,0,8304,6827,280,6547,0.04,0.96,
Southern Philippines Medical Center (SPMC),2020-05-21,243,193,5,188,0,3,16363,0,8547,7020,285,6735,0.04,0.96,
Southern Philippines Medical Center (SPMC),2020-05-22,192,151,9,142,0,0,16159,0,8739,7171,294,6877,0.04,0.96,
Southern Philippines Medical Center (SPMC),2020-05-23,178,121,2,119,0,1,15981,0,8917,7292,296,6996,0.04,0.96,
Southern Philippines Medical Center (SPMC),2020-05-24,44,42,2,40,0,0,159330,0,8961,7334,298,7036,0.04,0.96,
Southern Philippines Medical Center (SPMC),2020-05-25,188,130,21,109,0,0,15733,0,9149,7464,319,7145,0.04,0.96,
Southern Philippines Medical Center (SPMC),2020-05-26,99,69,4,65,0,0,20846,0,9248,7533,323,7210,0.04,0.96,
Southern Philippines Medical Center (SPMC),2020-05-27,209,110,0,110,0,2,25637,0,9457,7643,323,7320,0.04,0.96,
Southern Philippines Medical Center (SPMC),2020-05-28,283,190,53,137,0,4,43254,0,9740,7833,376,7457,0.05,0.95,
Southern Philippines Medical Center (SPMC),2020-05-29,281,231,18,213,0,0,42626,0,10021,8064,394,7670,0.05,0.95,
Southern Philippines Medical Center (SPMC),2020-05-30,223,130,3,127,0,1,42391,0,10244,8194,397,7797,0.05,0.95,
Southern Philippines Medical Center (SPMC),2020-05-31,66,48,0,48,0,0,42321,0,10310,8242,397,7845,0.05,0.95,
Southern Philippines Medical Center (SPMC),2020-06-01,284,191,6,185,0,4,42037,0,10594,8433,403,8030,0.05,0.95,
Southern Philippines Medical Center (SPMC),2020-06-02,304,189,4,185,0,2,41707,0,10898,8622,407,8215,0.05,0.95,
Southern Philippines Medical Center (SPMC),2020-06-03,276,168,2,166,0,0,41402,0,11174,8790,409,8381,0.05,0.95,
Southern Philippines Medical Center (SPMC),2020-06-04,265,199,5,194,0,0,41156,0,11439,8989,414,8575,0.05,0.95,
Southern Philippines Medical Center (SPMC),2020-06-05,346,294,7,287,0,0,40780,100,11785,9283,421,8862,0.05,0.95,
Southern Philippines Medical Center (SPMC),2020-06-06,222,193,4,189,0,0,40545,155,12007,9476,425,9051,0.04,0.96,
Southern Philippines Medical Center (SPMC),2020-06-07,63,63,0,63,0,0,40477,155,12070,9539,425,9114,0.04,0.96,
Southern Philippines Medical Center (SPMC),2020-06-08,450,447,14,433,0,0,40000,68,12520,9986,439,9547,0.04,0.96,
Southern Philippines Medical Center (SPMC),2020-06-09,404,275,13,262,0,0,39582,0,12924,10261,452,9809,0.04,0.96,
Southern Philippines Medical Center (SPMC),2020-06-10,361,249,28,221,0,0,39212,0,13285,10510,480,10030,0.05,0.95,
Southern Philippines Medical Center (SPMC),2020-06-11,402,316,10,306,0,0,38781,0,13687,10826,490,10336,0.05,0.95,
Southern Philippines Medical Center (SPMC),2020-06-12,361,260,23,237,0,0,38401,0,14048,11086,513,10573,0.05,0.95,
Southern Philippines Medical Center (SPMC),2020-06-13,135,126,4,122,0,0,38255,0,14183,11212,517,10695,0.05,0.95,
Southern Philippines Medical Center (SPMC),2020-06-14,53,52,0,52,0,0,38197,0,14236,11264,517,10747,0.05,0.95,
Southern Philippines Medical Center (SPMC),2020-06-15,160,95,2,93,0,0,38027,0,14396,11359,519,10840,0.05,0.95,
Southern Philippines Medical Center (SPMC),2020-06-16,298,212,3,209,0,0,37711,0,14694,11571,522,11049,0.05,0.95,
Southern Philippines Medical Center (SPMC),2020-06-17,407,263,25,238,0,0,37304,0,15101,11834,547,11287,0.05,0.95,
Southern Philippines Medical Center (SPMC),2020-06-18,364,312,10,302,0,0,36920,0,15465,12146,557,11589,0.05,0.95,
Southern Philippines Medical Center (SPMC),2020-06-19,412,346,41,305,0,0,36486,0,15877,12492,598,11894,0.05,0.95,
Southern Philippines Medical Center (SPMC),2020-06-20,337,294,11,283,0,0,36130,0,16214,12786,609,12177,0.05,0.95,
Southern Philippines Medical Center (SPMC),2020-06-21,78,75,2,73,0,0,36040,0,16292,12861,611,12250,0.05,0.95,
Southern Philippines Medical Center (SPMC),2020-06-22,139,99,1,98,0,0,35892,0,16431,12960,612,12348,0.05,0.95,
Southern Philippines Medical Center (SPMC),2020-06-23,349,259,14,245,0,0,35522,0,16780,13219,626,12593,0.05,0.95,
Southern Philippines Medical Center (SPMC),2020-06-24,360,249,28,221,0,0,35138,0,17140,13468,654,12814,0.05,0.95,
Southern Philippines Medical Center (SPMC),2020-06-25,300,221,9,212,0,0,34819,0,17440,13689,663,13026,0.05,0.95,
Southern Philippines Medical Center (SPMC),2020-06-26,359,272,23,249,0,0,34441,0,17799,13961,686,13275,0.05,0.95,
Southern Philippines Medical Center (SPMC),2020-06-27,310,261,12,249,0,0,34120,0,18109,14222,698,13524,0.05,0.95,
St. Luke's Medical Center - BGC (SLMC-BGC),2020-04-16,929,928,57,871,,,4790,,929,928,57,871,0.06,0.94,
St. Luke's Medical Center - BGC (SLMC-BGC),2020-04-17,291,291,8,283,,,3846,,1220,1219,65,1154,0.05,0.95,
St. Luke's Medical Center - BGC (SLMC-BGC),2020-04-18,399,399,23,376,,,82752,,1619,1618,88,1530,0.05,0.95,
St. Luke's Medical Center - BGC (SLMC-BGC),2020-04-19,419,369,56,313,,,11029,,2038,1987,144,1843,0.07,0.93,
St. Luke's Medical Center - BGC (SLMC-BGC),2020-04-20,243,226,28,198,,,10997,,2281,2213,172,2041,0.08,0.92,
St. Luke's Medical Center - BGC (SLMC-BGC),2020-04-21,558,511,47,464,,,10534,,2839,2724,219,2505,0.08,0.92,
St. Luke's Medical Center - BGC (SLMC-BGC),2020-04-22,164,73,0,73,,,10240,,3003,2797,219,2578,0.08,0.92,
St. Luke's Medical Center - BGC (SLMC-BGC),2020-04-23,287,238,11,227,,,9972,,3290,3035,230,2805,0.08,0.92,
St. Luke's Medical Center - BGC (SLMC-BGC),2020-04-24,135,58,5,53,,,8380,,3425,3093,235,2858,0.08,0.92,
St. Luke's Medical Center - BGC (SLMC-BGC),2020-04-25,220,220,54,166,,,7920,,3645,3313,289,3024,0.09,0.91,
St. Luke's Medical Center - BGC (SLMC-BGC),2020-04-26,469,431,12,419,,,21240,,4114,3744,301,3443,0.08,0.92,
St. Luke's Medical Center - BGC (SLMC-BGC),2020-04-27,348,325,9,316,,,20060,,4462,4069,310,3759,0.08,0.92,
St. Luke's Medical Center - BGC (SLMC-BGC),2020-04-28,284,250,9,241,,,21060,,4746,4319,319,4000,0.07,0.93,
St. Luke's Medical Center - BGC (SLMC-BGC),2020-04-29,48,0,0,0,,,20700,,4794,4319,319,4000,0.07,0.93,
St. Luke's Medical Center - BGC (SLMC-BGC),2020-04-30,351,254,60,194,,,20340,,5145,4573,379,4194,0.08,0.92,
St. Luke's Medical Center - BGC (SLMC-BGC),2020-05-01,78,68,5,63,,,21420,,5223,4641,384,4257,0.08,0.92,
St. Luke's Medical Center - BGC (SLMC-BGC),2020-05-02,287,245,59,186,,,20970,,5510,4886,443,4443,0.09,0.91,
St. Luke's Medical Center - BGC (SLMC-BGC),2020-05-03,374,360,45,315,,,20700,,5884,5246,488,4758,0.09,0.91,
St. Luke's Medical Center - BGC (SLMC-BGC),2020-05-04,276,229,33,196,,,20610,,6160,5475,521,4954,0.1,0.9,
St. Luke's Medical Center - BGC (SLMC-BGC),2020-05-05,243,191,32,159,,,20520,,6403,5666,553,5113,0.1,0.9,
St. Luke's Medical Center - BGC (SLMC-BGC),2020-05-06,211,141,18,123,,,20520,,6614,5807,571,5236,0.1,0.9,
St. Luke's Medical Center - BGC (SLMC-BGC),2020-05-07,207,192,19,173,,,18900,,6821,5999,590,5409,0.1,0.9,
St. Luke's Medical Center - BGC (SLMC-BGC),2020-05-08,457,425,33,392,,,18450,,7278,6424,623,5801,0.1,0.9,
St. Luke's Medical Center - BGC (SLMC-BGC),2020-05-09,286,221,48,173,,,18000,,7564,6645,671,5974,0.1,0.9,
St. Luke's Medical Center - BGC (SLMC-BGC),2020-05-10,140,117,16,101,,,17910,,7704,6762,687,6075,0.1,0.9,
St. Luke's Medical Center - BGC (SLMC-BGC),2020-05-11,0,0,0,0,,,17910,,7704,6762,687,6075,0.1,0.9,
St. Luke's Medical Center - BGC (SLMC-BGC),2020-05-12,0,0,0,0,,,17910,,7704,6762,687,6075,0.1,0.9,
St. Luke's Medical Center - BGC (SLMC-BGC),2020-05-13,220,195,4,191,,,25820,,7924,6957,691,6266,0.1,0.9,
St. Luke's Medical Center - BGC (SLMC-BGC),2020-05-14,356,268,20,248,,,25430,,8280,7225,711,6514,0.1,0.9,
St. Luke's Medical Center - BGC (SLMC-BGC),2020-05-15,291,243,11,232,,,24640,,8571,7468,722,6746,0.1,0.9,
St. Luke's Medical Center - BGC (SLMC-BGC),2020-05-16,278,109,7,102,0,0,24300,,8849,7577,729,6848,0.1,0.9,
St. Luke's Medical Center - BGC (SLMC-BGC),2020-05-17,275,145,15,130,0,0,24000,,9124,7722,744,6978,0.1,0.9,
St. Luke's Medical Center - BGC (SLMC-BGC),2020-05-18,393,263,8,255,0,0,24460,,9517,7985,752,7233,0.09,0.91,
St. Luke's Medical Center - BGC (SLMC-BGC),2020-05-19,418,288,6,282,0,5,2600,0,9935,8273,758,7515,0.09,0.91,
St. Luke's Medical Center - BGC (SLMC-BGC),2020-05-20,453,300,23,277,0,0,24080,0,10388,8573,781,7792,0.09,0.91,
St. Luke's Medical Center - BGC (SLMC-BGC),2020-05-21,357,260,18,242,0,0,22900,0,10745,8833,799,8034,0.09,0.91,
St. Luke's Medical Center - BGC (SLMC-BGC),2020-05-22,299,162,19,143,0,0,22520,0,11044,8995,818,8177,0.09,0.91,
St. Luke's Medical Center - BGC (SLMC-BGC),2020-05-23,451,265,28,237,0,0,22520,0,11495,9260,846,8414,0.09,0.91,
St. Luke's Medical Center - BGC (SLMC-BGC),2020-05-24,166,146,6,140,0,0,22520,0,11661,9406,852,8554,0.09,0.91,
St. Luke's Medical Center - BGC (SLMC-BGC),2020-05-25,341,202,20,182,0,0,22000,0,12002,9608,872,8736,0.09,0.91,
St. Luke's Medical Center - BGC (SLMC-BGC),2020-05-26,380,247,35,212,0,0,21490,0,12382,9855,907,8948,0.09,0.91,
St. Luke's Medical Center - BGC (SLMC-BGC),2020-05-27,195,99,12,87,0,0,22000,0,12577,9954,919,9035,0.09,0.91,
St. Luke's Medical Center - BGC (SLMC-BGC),2020-05-28,515,433,14,419,0,0,22000,0,13092,10387,933,9454,0.09,0.91,
St. Luke's Medical Center - BGC (SLMC-BGC),2020-05-29,314,253,3,250,0,0,22000,0,13406,10640,936,9704,0.09,0.91,
St. Luke's Medical Center - BGC (SLMC-BGC),2020-05-30,450,365,5,360,0,0,22000,0,13856,11005,941,10064,0.09,0.91,
St. Luke's Medical Center - BGC (SLMC-BGC),2020-05-31,470,377,16,361,0,0,22000,0,14326,11382,957,10425,0.08,0.92,
St. Luke's Medical Center - BGC (SLMC-BGC),2020-06-01,155,50,3,47,0,0,22000,0,14481,11432,960,10472,0.08,0.92,
St. Luke's Medical Center - BGC (SLMC-BGC),2020-06-02,198,176,1,175,0,0,22000,0,14679,11608,961,10647,0.08,0.92,
St. Luke's Medical Center - BGC (SLMC-BGC),2020-06-03,197,147,7,140,0,0,21000,0,14876,11755,968,10787,0.08,0.92,
St. Luke's Medical Center - BGC (SLMC-BGC),2020-06-04,276,218,13,205,0,0,21090,0,15152,11973,981,10992,0.08,0.92,
St. Luke's Medical Center - BGC (SLMC-BGC),2020-06-05,138,118,8,110,0,0,21000,0,15290,12091,989,11102,0.08,0.92,
St. Luke's Medical Center - BGC (SLMC-BGC),2020-06-06,142,104,11,93,0,0,21000,0,15432,12195,1000,11195,0.08,0.92,
St. Luke's Medical Center - BGC (SLMC-BGC),2020-06-07,232,203,10,193,0,0,21000,0,15664,12398,1010,11388,0.08,0.92,
St. Luke's Medical Center - BGC (SLMC-BGC),2020-06-08,155,153,1,152,0,0,21000,0,15819,12551,1011,11540,0.08,0.92,
St. Luke's Medical Center - BGC (SLMC-BGC),2020-06-09,294,246,8,238,0,0,21000,0,16113,12797,1019,11778,0.08,0.92,
St. Luke's Medical Center - BGC (SLMC-BGC),2020-06-10,123,77,2,75,0,0,21000,0,16236,12874,1021,11853,0.08,0.92,
St. Luke's Medical Center - BGC (SLMC-BGC),2020-06-11,188,157,10,147,0,0,20000,0,16424,13031,1031,12000,0.08,0.92,
St. Luke's Medical Center - BGC (SLMC-BGC),2020-06-12,303,223,11,212,0,0,20000,0,16727,13254,1042,12212,0.08,0.92,
St. Luke's Medical Center - BGC (SLMC-BGC),2020-06-13,121,71,16,55,0,0,20000,0,16848,13325,1058,12267,0.08,0.92,
St. Luke's Medical Center - BGC (SLMC-BGC),2020-06-14,145,127,24,103,0,0,20000,0,16993,13452,1082,12370,0.08,0.92,
St. Luke's Medical Center - BGC (SLMC-BGC),2020-06-15,85,66,6,60,0,1,20000,0,17078,13518,1088,12430,0.08,0.92,
St. Luke's Medical Center - BGC (SLMC-BGC),2020-06-16,210,136,12,124,0,0,20000,0,17288,13654,1100,12554,0.08,0.92,
St. Luke's Medical Center - BGC (SLMC-BGC),2020-06-17,335,193,15,178,0,0,20000,0,17623,13847,1115,12732,0.08,0.92,
St. Luke's Medical Center - BGC (SLMC-BGC),2020-06-18,266,128,26,102,0,0,2000,0,17889,13975,1141,12834,0.08,0.92,
St. Luke's Medical Center - BGC (SLMC-BGC),2020-06-19,281,97,2,95,0,0,20000,0,18170,14072,1143,12929,0.08,0.92,
St. Luke's Medical Center - BGC (SLMC-BGC),2020-06-20,255,103,20,83,0,0,20000,0,18425,14175,1163,13012,0.08,0.92,
St. Luke's Medical Center - BGC (SLMC-BGC),2020-06-21,450,211,29,182,0,0,20000,0,18875,14386,1192,13194,0.08,0.92,
St. Luke's Medical Center - BGC (SLMC-BGC),2020-06-22,235,127,40,87,0,0,20000,0,19110,14513,1232,13281,0.08,0.92,
St. Luke's Medical Center - BGC (SLMC-BGC),2020-06-23,149,101,21,80,0,0,20000,0,19259,14614,1253,13361,0.09,0.91,
St. Luke's Medical Center - BGC (SLMC-BGC),2020-06-24,247,156,32,124,0,0,20000,0,19506,14770,1285,13485,0.09,0.91,
St. Luke's Medical Center - BGC (SLMC-BGC),2020-06-25,338,258,42,216,0,0,20000,0,19844,15028,1327,13701,0.09,0.91,
St. Luke's Medical Center - BGC (SLMC-BGC),2020-06-26,279,187,24,163,0,0,2000,0,20123,15215,1351,13864,0.09,0.91,
St. Luke's Medical Center - BGC (SLMC-BGC),2020-06-27,381,265,25,240,0,0,20000,0,20504,15480,1376,14104,0.09,0.91,
St. Luke's Medical Center - Quezon City (SLMC-QC),2020-04-08,93,93,8,85,,,1800,,173,173,18,155,0.1,0.9,
St. Luke's Medical Center - Quezon City (SLMC-QC),2020-04-09,175,175,31,144,,,1704,,348,348,49,299,0.14,0.86,
St. Luke's Medical Center - Quezon City (SLMC-QC),2020-04-10,83,83,11,72,,,1560,,431,431,60,371,0.14,0.86,
St. Luke's Medical Center - Quezon City (SLMC-QC),2020-04-11,276,276,28,248,,,1488,,707,707,88,619,0.12,0.88,
St. Luke's Medical Center - Quezon City (SLMC-QC),2020-04-12,92,92,10,82,,,1272,,799,799,98,701,0.12,0.88,
St. Luke's Medical Center - Quezon City (SLMC-QC),2020-04-13,89,89,20,69,,,1200,,888,888,118,770,0.13,0.87,
St. Luke's Medical Center - Quezon City (SLMC-QC),2020-04-14,176,176,27,149,,,1056,,1064,1064,145,919,0.14,0.86,
St. Luke's Medical Center - Quezon City (SLMC-QC),2020-04-15,184,184,26,158,,,936,,1248,1248,171,1077,0.14,0.86,
St. Luke's Medical Center - Quezon City (SLMC-QC),2020-04-16,92,92,7,85,,,936,,1340,1340,178,1162,0.13,0.87,
St. Luke's Medical Center - Quezon City (SLMC-QC),2020-04-17,92,92,7,85,,,672,,1432,1432,185,1247,0.13,0.87,
St. Luke's Medical Center - Quezon City (SLMC-QC),2020-04-18,92,92,2,90,,,600,,1524,1524,187,1337,0.12,0.88,
St. Luke's Medical Center - Quezon City (SLMC-QC),2020-04-19,88,88,35,53,,,600,,1612,1612,222,1390,0.14,0.86,
St. Luke's Medical Center - Quezon City (SLMC-QC),2020-04-20,92,92,7,85,,,288,,1704,1704,229,1475,0.13,0.87,
St. Luke's Medical Center - Quezon City (SLMC-QC),2020-04-21,184,184,33,151,,,144,,1888,1888,262,1626,0.14,0.86,
St. Luke's Medical Center - Quezon City (SLMC-QC),2020-04-22,93,93,19,74,,,144,,1981,1981,281,1700,0.14,0.86,
St. Luke's Medical Center - Quezon City (SLMC-QC),2020-04-23,93,93,12,81,,,960,,2074,2074,293,1781,0.14,0.86,
St. Luke's Medical Center - Quezon City (SLMC-QC),2020-04-24,205,204,13,191,,,960,,2279,2278,306,1972,0.13,0.87,
St. Luke's Medical Center - Quezon City (SLMC-QC),2020-04-25,182,182,27,155,,,960,,2461,2460,333,2127,0.14,0.86,
St. Luke's Medical Center - Quezon City (SLMC-QC),2020-04-26,94,94,34,60,,,960,,2555,2554,367,2187,0.14,0.86,
St. Luke's Medical Center - Quezon City (SLMC-QC),2020-04-27,0,0,0,0,,,960,,2555,2554,367,2187,0.14,0.86,
St. Luke's Medical Center - Quezon City (SLMC-QC),2020-04-28,119,119,23,96,,,960,,2674,2673,390,2283,0.15,0.85,
St. Luke's Medical Center - Quezon City (SLMC-QC),2020-04-29,0,0,0,0,,,960,,2674,2673,390,2283,0.15,0.85,
St. Luke's Medical Center - Quezon City (SLMC-QC),2020-04-30,8,8,1,7,,,375,,2682,2681,391,2290,0.15,0.85,
St. Luke's Medical Center - Quezon City (SLMC-QC),2020-05-01,63,46,15,31,,,375,,2745,2727,406,2321,0.15,0.85,
St. Luke's Medical Center - Quezon City (SLMC-QC),2020-05-02,114,51,16,35,,,375,,2859,2778,422,2356,0.15,0.85,
St. Luke's Medical Center - Quezon City (SLMC-QC),2020-05-03,3,0,0,0,,,4416,,2862,2778,422,2356,0.15,0.85,
St. Luke's Medical Center - Quezon City (SLMC-QC),2020-05-04,138,21,0,21,,,4395,,3000,2799,422,2377,0.15,0.85,
St. Luke's Medical Center - Quezon City (SLMC-QC),2020-05-05,68,20,0,20,,,4194,,3068,2819,422,2397,0.15,0.85,
St. Luke's Medical Center - Quezon City (SLMC-QC),2020-05-06,180,180,99,81,,,3946,,3248,2999,521,2478,0.17,0.83,
St. Luke's Medical Center - Quezon City (SLMC-QC),2020-05-07,113,99,17,82,,,3946,,3361,3098,538,2560,0.17,0.83,
St. Luke's Medical Center - Quezon City (SLMC-QC),2020-05-08,67,54,12,42,,,3833,,3428,3152,550,2602,0.17,0.83,
St. Luke's Medical Center - Quezon City (SLMC-QC),2020-05-09,205,204,70,134,,,3766,,3633,3356,620,2736,0.18,0.82,
St. Luke's Medical Center - Quezon City (SLMC-QC),2020-05-10,85,84,24,60,,,3476,,3718,3440,644,2796,0.19,0.81,
St. Luke's Medical Center - Quezon City (SLMC-QC),2020-05-11,117,117,32,85,,,3539,,3835,3557,676,2881,0.19,0.81,
St. Luke's Medical Center - Quezon City (SLMC-QC),2020-05-12,174,160,65,95,,,3337,,4009,3717,741,2976,0.2,0.8,
St. Luke's Medical Center - Quezon City (SLMC-QC),2020-05-13,100,90,19,71,,,2880,,4109,3807,760,3047,0.2,0.8,
St. Luke's Medical Center - Quezon City (SLMC-QC),2020-05-14,114,82,19,63,,,2766,,4223,3889,779,3110,0.2,0.8,
St. Luke's Medical Center - Quezon City (SLMC-QC),2020-05-15,208,125,55,70,,,2556,,4431,4014,834,3180,0.21,0.79,
St. Luke's Medical Center - Quezon City (SLMC-QC),2020-05-16,182,162,49,113,0,0,2374,,4613,4176,883,3293,0.21,0.79,
St. Luke's Medical Center - Quezon City (SLMC-QC),2020-05-17,158,97,23,74,0,0,2216,,4771,4273,906,3367,0.21,0.79,
St. Luke's Medical Center - Quezon City (SLMC-QC),2020-05-18,224,188,42,146,0,0,1992,,4995,4461,948,3513,0.21,0.79,
St. Luke's Medical Center - Quezon City (SLMC-QC),2020-05-19,125,91,13,78,0,0,1867,0,5120,4552,961,3591,0.21,0.79,
St. Luke's Medical Center - Quezon City (SLMC-QC),2020-05-20,218,116,17,99,0,0,1649,0,5338,4668,978,3690,0.21,0.79,
St. Luke's Medical Center - Quezon City (SLMC-QC),2020-05-21,288,87,14,73,0,0,1361,0,5626,4755,992,3763,0.21,0.79,
St. Luke's Medical Center - Quezon City (SLMC-QC),2020-05-22,352,150,13,137,0,0,8209,0,5978,4905,1005,3900,0.2,0.8,
St. Luke's Medical Center - Quezon City (SLMC-QC),2020-05-23,373,132,19,113,0,0,7836,0,6351,5037,1024,4013,0.2,0.8,
St. Luke's Medical Center - Quezon City (SLMC-QC),2020-05-24,222,127,5,122,0,0,7614,0,6573,5164,1029,4135,0.2,0.8,
St. Luke's Medical Center - Quezon City (SLMC-QC),2020-05-25,340,179,43,136,0,0,7274,0,6913,5343,1072,4271,0.2,0.8,
St. Luke's Medical Center - Quezon City (SLMC-QC),2020-05-26,304,139,9,130,0,0,6970,0,7217,5482,1081,4401,0.2,0.8,
St. Luke's Medical Center - Quezon City (SLMC-QC),2020-05-27,270,135,14,121,0,0,6700,0,7487,5617,1095,4522,0.19,0.81,
St. Luke's Medical Center - Quezon City (SLMC-QC),2020-05-28,194,90,19,71,0,0,6506,0,7681,5707,1114,4593,0.2,0.8,
St. Luke's Medical Center - Quezon City (SLMC-QC),2020-05-29,193,114,10,104,0,0,6313,0,7874,5821,1124,4697,0.19,0.81,
St. Luke's Medical Center - Quezon City (SLMC-QC),2020-05-30,230,133,13,120,0,0,6083,0,8104,5954,1137,4817,0.19,0.81,
St. Luke's Medical Center - Quezon City (SLMC-QC),2020-05-31,218,187,8,179,0,0,5865,0,8322,6141,1145,4996,0.19,0.81,
St. Luke's Medical Center - Quezon City (SLMC-QC),2020-06-01,167,130,14,116,0,0,5698,0,8489,6271,1159,5112,0.18,0.82,
St. Luke's Medical Center - Quezon City (SLMC-QC),2020-06-02,146,86,7,79,0,0,5552,0,8635,6357,1166,5191,0.18,0.82,
St. Luke's Medical Center - Quezon City (SLMC-QC),2020-06-03,162,107,15,92,0,0,5390,0,8797,6464,1181,5283,0.18,0.82,
St. Luke's Medical Center - Quezon City (SLMC-QC),2020-06-04,129,46,17,29,0,0,5261,0,8926,6510,1198,5312,0.18,0.82,
St. Luke's Medical Center - Quezon City (SLMC-QC),2020-06-05,253,168,48,120,0,0,5008,0,9179,6678,1246,5432,0.19,0.81,
St. Luke's Medical Center - Quezon City (SLMC-QC),2020-06-06,90,46,3,43,0,0,4918,0,9269,6724,1249,5475,0.19,0.81,
St. Luke's Medical Center - Quezon City (SLMC-QC),2020-06-07,122,76,9,67,0,0,4796,0,9391,6800,1258,5542,0.18,0.81,
St. Luke's Medical Center - Quezon City (SLMC-QC),2020-06-08,82,45,7,38,0,1,4714,0,9473,6845,1265,5580,0.18,0.82,
St. Luke's Medical Center - Quezon City (SLMC-QC),2020-06-09,118,80,9,71,0,0,4596,0,9591,6925,1274,5651,0.18,0.82,
St. Luke's Medical Center - Quezon City (SLMC-QC),2020-06-10,94,72,16,56,0,0,4502,0,9685,6997,1290,5707,0.18,0.82,
St. Luke's Medical Center - Quezon City (SLMC-QC),2020-06-11,174,121,18,103,0,0,4328,0,9859,7118,1308,5810,0.18,0.82,
St. Luke's Medical Center - Quezon City (SLMC-QC),2020-06-12,178,117,27,90,0,0,4150,0,10037,7235,1335,5900,0.18,0.82,
St. Luke's Medical Center - Quezon City (SLMC-QC),2020-06-13,129,95,18,77,0,0,4021,0,10166,7330,1353,5977,0.18,0.82,
St. Luke's Medical Center - Quezon City (SLMC-QC),2020-06-14,71,55,13,42,0,0,3950,0,10237,7385,1366,6019,0.18,0.82,
St. Luke's Medical Center - Quezon City (SLMC-QC),2020-06-15,135,102,10,92,0,0,3815,0,10372,7487,1376,6111,0.18,0.82,
St. Luke's Medical Center - Quezon City (SLMC-QC),2020-06-16,243,81,23,58,0,0,3572,0,10615,7568,1399,6169,0.18,0.82,
St. Luke's Medical Center - Quezon City (SLMC-QC),2020-06-17,273,102,9,93,0,0,3299,0,10888,7670,1408,6262,0.18,0.82,
St. Luke's Medical Center - Quezon City (SLMC-QC),2020-06-18,263,100,10,90,0,0,3036,0,11151,7770,1418,6352,0.18,0.82,
St. Luke's Medical Center - Quezon City (SLMC-QC),2020-06-19,320,135,14,121,0,0,2716,0,11471,7905,1432,6473,0.18,0.82,
St. Luke's Medical Center - Quezon City (SLMC-QC),2020-06-20,343,107,7,100,0,0,2373,0,11814,8012,1439,6573,0.18,0.82,
St. Luke's Medical Center - Quezon City (SLMC-QC),2020-06-21,165,21,0,21,0,0,2208,0,11979,8033,1439,6594,0.18,0.82,
St. Luke's Medical Center - Quezon City (SLMC-QC),2020-06-22,181,125,28,97,0,0,2027,0,12160,8158,1467,6691,0.18,0.82,
St. Luke's Medical Center - Quezon City (SLMC-QC),2020-06-23,164,61,8,53,0,0,1863,0,12324,8219,1475,6744,0.18,0.82,
St. Luke's Medical Center - Quezon City (SLMC-QC),2020-06-24,490,224,30,194,0,0,1373,0,12814,8443,1505,6938,0.18,0.82,
St. Luke's Medical Center - Quezon City (SLMC-QC),2020-06-25,232,125,10,115,0,0,1141,0,13046,8568,1515,7053,0.18,0.82,
St. Luke's Medical Center - Quezon City (SLMC-QC),2020-06-26,145,119,46,73,0,0,996,0,13191,8687,1561,7126,0.18,0.82,
St. Luke's Medical Center - Quezon City (SLMC-QC),2020-06-27,229,210,53,157,0,0,767,0,13420,8897,1614,7283,0.18,0.82,
Teresita Jalandoni Provincial Hospital,2020-06-04,20,20,1,19,0,0,9980,0,20,20,1,19,0.05,0.95,
Teresita Jalandoni Provincial Hospital,2020-06-05,30,30,0,30,0,0,9950,0,50,50,1,49,0.02,0.98,
Teresita Jalandoni Provincial Hospital,2020-06-06,200,200,0,200,0,0,9750,0,250,250,1,249,0.0,1.0,
Teresita Jalandoni Provincial Hospital,2020-06-07,60,60,0,60,0,0,9685,0,310,310,1,309,0.0,1.0,
Teresita Jalandoni Provincial Hospital,2020-06-08,,,,,,,,,310,310,1,309,0.0,1.0,
Teresita Jalandoni Provincial Hospital,2020-06-09,186,186,2,184,0,0,9303,0,496,496,3,493,0.01,0.99,
Teresita Jalandoni Provincial Hospital,2020-06-10,,,,,,,,,496,496,3,493,0.01,0.99,
Teresita Jalandoni Provincial Hospital,2020-06-11,,,,,,,,,496,496,3,493,0.01,0.99,
Teresita Jalandoni Provincial Hospital,2020-06-12,,,,,,,,,496,496,3,493,0.01,0.99,
Teresita Jalandoni Provincial Hospital,2020-06-13,,,,,,,,,496,496,3,493,0.01,0.99,
Teresita Jalandoni Provincial Hospital,2020-06-14,,,,,,,,,496,496,3,493,0.01,0.99,
Teresita Jalandoni Provincial Hospital,2020-06-15,,,,,,,,,496,496,3,493,0.01,0.99,
Teresita Jalandoni Provincial Hospital,2020-06-16,,,,,,,,,496,496,3,493,0.01,0.99,
Teresita Jalandoni Provincial Hospital,2020-06-17,,,,,,,,,496,496,3,493,0.01,0.99,
Teresita Jalandoni Provincial Hospital,2020-06-18,223,223,2,221,0,0,6945,1297,719,719,5,714,0.01,0.99,
Teresita Jalandoni Provincial Hospital,2020-06-19,,,,,,,,,719,719,5,714,0.01,0.99,
Teresita Jalandoni Provincial Hospital,2020-06-20,,,,,,,,,719,719,5,714,0.01,0.99,
Teresita Jalandoni Provincial Hospital,2020-06-21,,,,,,,,,719,719,5,714,0.01,0.99,
Teresita Jalandoni Provincial Hospital,2020-06-22,,,,,,,,,719,719,5,714,0.01,0.99,
Teresita Jalandoni Provincial Hospital,2020-06-23,,,,,,,,,719,719,5,714,0.01,0.99,
Teresita Jalandoni Provincial Hospital,2020-06-24,,,,,,,,,719,719,5,714,0.01,0.99,
Teresita Jalandoni Provincial Hospital,2020-06-25,,,,,,,,,719,719,5,714,0.01,0.99,
Teresita Jalandoni Provincial Hospital,2020-06-26,,,,,,,,,719,719,5,714,0.01,0.99,
Teresita Jalandoni Provincial Hospital,2020-06-27,,,,,,,,,719,719,5,714,0.01,0.99,
The Medical City (TMC),2020-04-14,20,20,2,18,,,1945,,20,20,2,18,0.1,0.9,
The Medical City (TMC),2020-04-15,40,40,5,35,,,1917,,60,60,7,53,0.12,0.88,
The Medical City (TMC),2020-04-16,33,33,6,27,,,1891,,93,93,13,80,0.14,0.86,
The Medical City (TMC),2020-04-17,69,69,5,64,,,1816,,162,162,18,144,0.11,0.89,
The Medical City (TMC),2020-04-18,70,70,5,65,,,1741,,232,232,23,209,0.1,0.9,
The Medical City (TMC),2020-04-19,33,33,6,27,,,1741,,265,265,29,236,0.11,0.89,
The Medical City (TMC),2020-04-20,86,86,16,70,,,1773,,351,351,45,306,0.13,0.87,
The Medical City (TMC),2020-04-21,39,39,11,28,,,1773,,390,390,56,334,0.14,0.86,
The Medical City (TMC),2020-04-22,69,69,7,62,,,1677,,459,459,63,396,0.14,0.86,
The Medical City (TMC),2020-04-23,41,41,6,35,,,1677,,500,500,69,431,0.14,0.86,
The Medical City (TMC),2020-04-24,54,54,13,41,,,1537,,554,554,82,472,0.15,0.85,
The Medical City (TMC),2020-04-25,64,64,12,52,,,1537,,618,618,94,524,0.15,0.85,
The Medical City (TMC),2020-04-26,116,116,21,95,,,1363,,734,734,115,619,0.16,0.84,
The Medical City (TMC),2020-04-27,61,61,11,50,,,1537,,795,795,126,669,0.16,0.84,
The Medical City (TMC),2020-04-28,80,80,8,72,,,1363,,875,875,134,741,0.15,0.85,
The Medical City (TMC),2020-04-29,104,104,12,92,,,1206,,979,979,146,833,0.15,0.85,
The Medical City (TMC),2020-04-30,88,88,11,77,,,1206,,1067,1067,157,910,0.15,0.85,
The Medical City (TMC),2020-05-01,113,113,15,98,,,1023,,1180,1180,172,1008,0.15,0.85,
The Medical City (TMC),2020-05-02,139,139,22,117,,,1023,,1319,1319,194,1125,0.15,0.85,
The Medical City (TMC),2020-05-03,50,41,8,33,,,1023,,1369,1360,202,1158,0.15,0.85,
The Medical City (TMC),2020-05-04,142,132,22,110,,,1023,,1511,1492,224,1268,0.15,0.85,
The Medical City (TMC),2020-05-05,89,87,13,74,,,1023,,1600,1579,237,1342,0.15,0.85,
The Medical City (TMC),2020-05-06,121,118,21,97,,,1023,,1721,1697,258,1439,0.15,0.85,
The Medical City (TMC),2020-05-07,124,117,13,104,,,1023,,1845,1814,271,1543,0.15,0.85,
The Medical City (TMC),2020-05-08,146,146,44,102,,,1023,,1991,1960,315,1645,0.16,0.84,
The Medical City (TMC),2020-05-09,89,86,12,74,,,1020,,2080,2046,327,1719,0.16,0.84,
The Medical City (TMC),2020-05-10,108,108,19,89,,,373,,2188,2154,346,1808,0.16,0.84,
The Medical City (TMC),2020-05-11,123,123,15,108,,,373,,2311,2277,361,1916,0.16,0.84,
The Medical City (TMC),2020-05-12,99,98,9,89,,,1175,,2410,2375,370,2005,0.16,0.84,
The Medical City (TMC),2020-05-13,120,120,22,98,,,300,,2530,2495,392,2103,0.16,0.84,
The Medical City (TMC),2020-05-14,155,155,26,129,,,1000,,2685,2650,418,2232,0.16,0.84,
The Medical City (TMC),2020-05-15,152,152,29,123,,,2100,,2837,2802,447,2355,0.16,0.84,
The Medical City (TMC),2020-05-16,121,121,24,97,0,0,1975,,2958,2923,471,2452,0.16,0.84,
The Medical City (TMC),2020-05-17,109,109,26,83,0,0,1866,,3067,3032,497,2535,0.16,0.84,
The Medical City (TMC),2020-05-18,143,143,33,110,0,0,1723,,3210,3175,530,2645,0.17,0.83,
The Medical City (TMC),2020-05-19,92,92,20,72,0,0,1631,150,3302,3267,550,2717,0.17,0.83,
The Medical City (TMC),2020-05-20,102,102,4,98,0,0,1529,150,3404,3369,554,2815,0.16,0.84,
The Medical City (TMC),2020-05-21,155,146,11,135,0,0,1374,130,3559,3515,565,2950,0.16,0.84,
The Medical City (TMC),2020-05-22,129,114,11,103,0,0,1245,150,3688,3629,576,3053,0.16,0.84,
The Medical City (TMC),2020-05-23,148,128,5,123,0,0,1098,150,3836,3757,581,3176,0.15,0.85,
The Medical City (TMC),2020-05-24,178,122,7,115,0,0,920,150,4014,3879,588,3291,0.15,0.85,
The Medical City (TMC),2020-05-25,121,113,10,103,0,0,2799,140,4135,3992,598,3394,0.15,0.85,
The Medical City (TMC),2020-05-26,109,82,4,78,0,0,2690,0,4244,4074,602,3472,0.15,0.85,
The Medical City (TMC),2020-05-27,102,84,2,82,0,0,2588,0,4346,4158,604,3554,0.15,0.85,
The Medical City (TMC),2020-05-28,103,84,1,83,0,0,2485,0,4449,4242,605,3637,0.14,0.86,
The Medical City (TMC),2020-05-29,161,115,20,95,0,0,2324,0,4610,4357,625,3732,0.14,0.86,
The Medical City (TMC),2020-05-30,189,132,17,115,0,0,2135,0,4799,4489,642,3847,0.14,0.86,
The Medical City (TMC),2020-05-31,175,135,14,121,0,0,1960,0,4974,4624,656,3968,0.14,0.86,
The Medical City (TMC),2020-06-01,183,134,11,123,0,0,1777,0,5157,4758,667,4091,0.14,0.86,
The Medical City (TMC),2020-06-02,76,36,2,34,0,0,1701,0,5233,4794,669,4125,0.14,0.86,
The Medical City (TMC),2020-06-03,98,76,4,72,0,0,1603,0,5331,4870,673,4197,0.14,0.86,
The Medical City (TMC),2020-06-04,157,128,5,123,0,0,1446,0,5488,4998,678,4320,0.14,0.86,
The Medical City (TMC),2020-06-05,167,130,6,124,0,0,1279,0,5655,5128,684,4444,0.13,0.87,
The Medical City (TMC),2020-06-06,134,105,2,103,0,0,1145,0,5789,5233,686,4547,0.13,0.87,
The Medical City (TMC),2020-06-07,179,122,9,113,0,0,966,0,5968,5355,695,4660,0.13,0.87,
The Medical City (TMC),2020-06-08,122,107,5,102,0,0,842,0,6090,5462,700,4762,0.13,0.87,
The Medical City (TMC),2020-06-09,44,35,1,34,0,0,798,0,6134,5497,701,4796,0.13,0.87,
The Medical City (TMC),2020-06-10,100,83,7,76,0,0,698,0,6234,5580,708,4872,0.13,0.87,
The Medical City (TMC),2020-06-11,160,112,9,103,0,0,538,0,6394,5692,717,4975,0.13,0.87,
The Medical City (TMC),2020-06-12,147,110,13,97,0,0,1391,0,6541,5802,730,5072,0.13,0.87,
The Medical City (TMC),2020-06-13,177,146,24,122,0,0,1214,0,6718,5948,754,5194,0.13,0.87,
The Medical City (TMC),2020-06-14,71,59,10,49,0,0,1143,0,6789,6007,764,5243,0.13,0.87,
The Medical City (TMC),2020-06-15,156,99,4,95,0,0,987,0,6945,6106,768,5338,0.13,0.87,
The Medical City (TMC),2020-06-16,191,142,5,137,0,0,758,0,7136,6248,773,5475,0.12,0.88,
The Medical City (TMC),2020-06-17,191,142,5,137,0,0,758,0,7327,6390,778,5612,0.12,0.88,
The Medical City (TMC),2020-06-18,140,91,4,87,0,0,618,0,7467,6481,782,5699,0.12,0.88,
The Medical City (TMC),2020-06-19,169,129,11,118,0,0,1383,0,7636,6610,793,5817,0.12,0.88,
The Medical City (TMC),2020-06-20,160,134,15,119,0,0,1392,0,7796,6744,808,5936,0.12,0.88,
The Medical City (TMC),2020-06-21,150,118,10,108,0,0,1242,0,7946,6862,818,6044,0.12,0.88,
The Medical City (TMC),2020-06-22,169,141,18,123,0,0,1073,0,8115,7003,836,6167,0.12,0.88,
The Medical City (TMC),2020-06-23,50,47,7,40,0,0,1023,0,8165,7050,843,6207,0.12,0.88,
The Medical City (TMC),2020-06-24,127,97,11,86,0,0,896,0,8292,7147,854,6293,0.12,0.88,
The Medical City (TMC),2020-06-25,132,124,42,82,0,0,764,0,8424,7271,896,6375,0.12,0.88,
The Medical City (TMC),2020-06-26,98,74,5,69,0,0,666,0,8522,7345,901,6444,0.12,0.88,
The Medical City (TMC),2020-06-27,177,114,16,98,0,0,489,72,8699,7459,917,6542,0.12,0.88,
Tondo Medical Center GeneXpert Laboratory,2020-05-26,14,14,1,13,,0,1231,0,14,14,1,13,0.07,0.93,
Tondo Medical Center GeneXpert Laboratory,2020-05-27,11,11,2,9,0,0,1206,0,25,25,3,22,0.12,0.88,
Tondo Medical Center GeneXpert Laboratory,2020-05-28,14,14,1,13,0,0,1199,0,39,39,4,35,0.1,0.9,
Tondo Medical Center GeneXpert Laboratory,2020-05-29,24,24,8,16,0,0,1175,0,63,63,12,51,0.19,0.81,
Tondo Medical Center GeneXpert Laboratory,2020-05-30,15,15,3,12,0,0,1160,0,78,78,15,63,0.19,0.81,
Tondo Medical Center GeneXpert Laboratory,2020-05-31,10,10,1,9,0,0,1150,0,88,88,16,72,0.18,0.82,
Tondo Medical Center GeneXpert Laboratory,2020-06-01,26,26,2,24,0,0,1134,0,114,114,18,96,0.16,0.84,
Tondo Medical Center GeneXpert Laboratory,2020-06-02,23,23,4,19,0,0,1109,0,137,137,22,115,0.16,0.84,
Tondo Medical Center GeneXpert Laboratory,2020-06-03,20,20,3,17,0,0,1089,0,157,157,25,132,0.16,0.84,
Tondo Medical Center GeneXpert Laboratory,2020-06-04,16,16,4,12,0,0,1073,0,173,173,29,144,0.17,0.83,
Tondo Medical Center GeneXpert Laboratory,2020-06-05,20,20,7,13,0,0,1053,0,193,193,36,157,0.19,0.81,
Tondo Medical Center GeneXpert Laboratory,2020-06-06,21,21,4,17,0,0,1032,0,214,214,40,174,0.19,0.81,
Tondo Medical Center GeneXpert Laboratory,2020-06-07,9,9,2,7,0,0,1022,0,223,223,42,181,0.19,0.81,
Tondo Medical Center GeneXpert Laboratory,2020-06-08,31,25,4,21,0,0,991,0,254,248,46,202,0.19,0.81,
Tondo Medical Center GeneXpert Laboratory,2020-06-09,13,13,2,11,0,0,978,0,267,261,48,213,0.18,0.82,
Tondo Medical Center GeneXpert Laboratory,2020-06-10,39,39,6,33,0,0,939,0,306,300,54,246,0.18,0.82,
Tondo Medical Center GeneXpert Laboratory,2020-06-11,36,36,5,31,0,0,921,0,342,336,59,277,0.18,0.82,
Tondo Medical Center GeneXpert Laboratory,2020-06-12,48,48,10,38,0,0,855,0,390,384,69,315,0.18,0.82,
Tondo Medical Center GeneXpert Laboratory,2020-06-13,54,54,11,43,0,0,831,0,444,438,80,358,0.18,0.82,
Tondo Medical Center GeneXpert Laboratory,2020-06-14,25,25,7,18,0,0,809,0,469,463,87,376,0.19,0.81,
Tondo Medical Center GeneXpert Laboratory,2020-06-15,44,44,8,36,0,0,732,0,513,507,95,412,0.19,0.81,
Tondo Medical Center GeneXpert Laboratory,2020-06-16,49,49,9,40,0,0,680,0,562,556,104,452,0.19,0.81,
Tondo Medical Center GeneXpert Laboratory,2020-06-17,72,72,9,63,0,0,606,0,634,628,113,515,0.18,0.82,
Tondo Medical Center GeneXpert Laboratory,2020-06-18,54,54,12,42,0,0,554,0,688,682,125,557,0.18,0.82,
Tondo Medical Center GeneXpert Laboratory,2020-06-19,71,71,23,48,0,0,479,0,759,753,148,605,0.2,0.8,
Tondo Medical Center GeneXpert Laboratory,2020-06-20,44,44,11,33,0,0,435,0,803,797,159,638,0.2,0.8,
Tondo Medical Center GeneXpert Laboratory,2020-06-21,17,17,9,8,0,0,418,0,820,814,168,646,0.21,0.79,
Tondo Medical Center GeneXpert Laboratory,2020-06-22,36,36,8,28,0,0,382,0,856,850,176,674,0.21,0.79,
Tondo Medical Center GeneXpert Laboratory,2020-06-23,34,34,7,27,0,0,346,0,890,884,183,701,0.21,0.79,
Tondo Medical Center GeneXpert Laboratory,2020-06-24,26,26,8,18,0,0,319,0,916,910,191,719,0.21,0.79,
Tondo Medical Center GeneXpert Laboratory,2020-06-25,61,61,9,52,0,0,272,0,977,971,200,771,0.21,0.79,
Tondo Medical Center GeneXpert Laboratory,2020-06-26,59,59,14,45,0,0,750,0,1036,1030,214,816,0.21,0.79,
Tondo Medical Center GeneXpert Laboratory,2020-06-27,40,40,11,29,0,0,710,0,1076,1070,225,845,0.21,0.79,
Tropical Disease Foundation,2020-06-03,16,16,0,16,0,0,974,0,16,16,0,16,0.0,1.0,
Tropical Disease Foundation,2020-06-04,15,11,0,11,0,0,964,0,31,27,0,27,0.0,1.0,
Tropical Disease Foundation,2020-06-05,7,7,0,7,0,0,956,0,38,34,0,34,0.0,1.0,
Tropical Disease Foundation,2020-06-06,,,,,,,,,38,34,0,34,0.0,1.0,
Tropical Disease Foundation,2020-06-07,0,0,0,0,0,0,956,14,38,34,0,34,0.0,1.0,
Tropical Disease Foundation,2020-06-08,14,12,0,12,0,2,905,2,52,46,0,46,0.0,1.0,
Tropical Disease Foundation,2020-06-09,31,31,0,31,0,0,873,0,83,77,0,77,0.0,1.0,
Tropical Disease Foundation,2020-06-10,5,5,0,5,0,0,899,0,88,82,0,82,0.0,1.0,
Tropical Disease Foundation,2020-06-11,,,,,,,,,88,82,0,82,0.0,1.0,
Tropical Disease Foundation,2020-06-12,19,19,0,19,0,0,859,0,107,101,0,101,0.0,1.0,
Tropical Disease Foundation,2020-06-13,0,0,0,0,0,0,859,0,107,101,0,101,0.0,1.0,
Tropical Disease Foundation,2020-06-14,0,0,0,0,0,0,859,24,107,101,0,101,0.0,1.0,
Tropical Disease Foundation,2020-06-15,24,23,0,23,0,0,832,0,131,124,0,124,0.0,1.0,
Tropical Disease Foundation,2020-06-16,24,22,0,22,0,2,832,0,155,146,0,146,0.0,1.0,
Tropical Disease Foundation,2020-06-17,27,27,0,27,0,0,800,0,182,173,0,173,0.0,1.0,
Tropical Disease Foundation,2020-06-18,44,41,2,39,0,0,1668,0,226,214,2,212,0.01,0.99,
Tropical Disease Foundation,2020-06-19,38,38,0,38,0,0,1624,3,264,252,2,250,0.01,0.99,
Tropical Disease Foundation,2020-06-20,,,,,,,,,264,252,2,250,0.01,0.99,
Tropical Disease Foundation,2020-06-21,,,,,,,,,264,252,2,250,0.01,0.99,
Tropical Disease Foundation,2020-06-22,31,30,0,30,0,0,1353,3,295,282,2,280,0.01,0.99,
Tropical Disease Foundation,2020-06-23,89,84,11,73,0,2,1251,0,384,366,13,353,0.04,0.96,
Tropical Disease Foundation,2020-06-24,42,3,3,0,0,0,1206,2,426,369,16,353,0.04,0.96,
Tropical Disease Foundation,2020-06-25,83,50,11,39,0,0,1117,0,509,419,27,392,0.06,0.94,
Tropical Disease Foundation,2020-06-26,114,113,17,96,0,0,993,0,623,532,44,488,0.08,0.92,
Tropical Disease Foundation,2020-06-27,,,,,,,,,623,532,44,488,0.08,0.92,
UP National Institutes of Health (UP-NIH),2020-04-03,22,19,0,19,,,4514,,357,351,43,308,0.12,0.88,
UP National Institutes of Health (UP-NIH),2020-04-04,28,23,6,17,,,4479,,385,374,49,325,0.13,0.87,
UP National Institutes of Health (UP-NIH),2020-04-05,1,1,0,1,,,4479,,386,375,49,326,0.13,0.87,
UP National Institutes of Health (UP-NIH),2020-04-06,0,0,0,0,,,4479,,386,375,49,326,0.13,0.87,
UP National Institutes of Health (UP-NIH),2020-04-07,136,124,39,85,,,4421,,522,499,88,411,0.18,0.82,
UP National Institutes of Health (UP-NIH),2020-04-08,31,13,13,0,,,4421,,553,512,101,411,0.2,0.8,
UP National Institutes of Health (UP-NIH),2020-04-09,21,21,4,17,,,4242,,574,533,105,428,0.2,0.8,
UP National Institutes of Health (UP-NIH),2020-04-10,40,39,7,32,,,4142,,614,572,112,460,0.2,0.8,
UP National Institutes of Health (UP-NIH),2020-04-11,29,26,7,19,,,4100,,643,598,119,479,0.2,0.8,
UP National Institutes of Health (UP-NIH),2020-04-12,10,8,3,5,,,4080,,653,606,122,484,0.2,0.8,
UP National Institutes of Health (UP-NIH),2020-04-13,144,134,23,111,,,3922,,797,740,145,595,0.2,0.8,
UP National Institutes of Health (UP-NIH),2020-04-14,47,47,3,44,,,3867,,844,787,148,639,0.19,0.81,
UP National Institutes of Health (UP-NIH),2020-04-15,118,116,36,80,,,3729,,962,903,184,719,0.2,0.8,
UP National Institutes of Health (UP-NIH),2020-04-16,131,130,16,114,,,3568,,1093,1033,200,833,0.19,0.81,
UP National Institutes of Health (UP-NIH),2020-04-17,96,96,8,88,,,3464,,1189,1129,208,921,0.18,0.82,
UP National Institutes of Health (UP-NIH),2020-04-18,85,84,4,80,,,3464,,1274,1213,212,1001,0.17,0.83,
UP National Institutes of Health (UP-NIH),2020-04-19,82,82,12,70,,,3225,,1356,1295,224,1071,0.17,0.83,
UP National Institutes of Health (UP-NIH),2020-04-20,93,92,9,83,,,3093,,1449,1387,233,1154,0.17,0.83,
UP National Institutes of Health (UP-NIH),2020-04-21,271,267,40,227,,,2799,,1720,1654,273,1381,0.17,0.83,
UP National Institutes of Health (UP-NIH),2020-04-22,298,290,32,258,,,2436,,2018,1944,305,1639,0.16,0.84,
UP National Institutes of Health (UP-NIH),2020-04-23,300,292,37,255,,,2116,,2318,2236,342,1894,0.15,0.85,
UP National Institutes of Health (UP-NIH),2020-04-24,370,336,52,284,,,1698,,2688,2572,394,2178,0.15,0.85,
UP National Institutes of Health (UP-NIH),2020-04-25,369,338,57,281,,,1296,,3057,2910,451,2459,0.15,0.85,
UP National Institutes of Health (UP-NIH),2020-04-26,192,192,31,161,,,1296,,3249,3102,482,2620,0.16,0.84,
UP National Institutes of Health (UP-NIH),2020-04-27,240,222,30,192,,,0,,3489,3324,512,2812,0.15,0.85,
UP National Institutes of Health (UP-NIH),2020-04-28,67,25,3,22,,,0,,3556,3349,515,2834,0.15,0.85,
UP National Institutes of Health (UP-NIH),2020-04-29,0,0,0,0,,,0,,3556,3349,515,2834,0.15,0.85,
UP National Institutes of Health (UP-NIH),2020-04-30,435,420,54,366,,,1229,,3991,3769,569,3200,0.15,0.85,
UP National Institutes of Health (UP-NIH),2020-05-01,504,503,93,410,,,645,,4495,4272,662,3610,0.15,0.85,
UP National Institutes of Health (UP-NIH),2020-05-02,464,425,65,360,,,360,,4959,4697,727,3970,0.15,0.85,
UP National Institutes of Health (UP-NIH),2020-05-03,232,219,35,184,,,112,,5191,4916,762,4154,0.16,0.84,
UP National Institutes of Health (UP-NIH),2020-05-04,348,347,49,298,,,1632,,5539,5263,811,4452,0.15,0.85,
UP National Institutes of Health (UP-NIH),2020-05-05,170,170,18,152,,,1500,,5709,5433,829,4604,0.15,0.85,
UP National Institutes of Health (UP-NIH),2020-05-06,116,113,17,96,,,1500,,5825,5546,846,4700,0.15,0.85,
UP National Institutes of Health (UP-NIH),2020-05-07,239,234,25,209,,,6000,,6064,5780,871,4909,0.15,0.85,
UP National Institutes of Health (UP-NIH),2020-05-08,464,464,62,402,,,5000,,6528,6244,933,5311,0.15,0.85,
UP National Institutes of Health (UP-NIH),2020-05-09,174,174,26,148,,,4784,,6702,6418,959,5459,0.15,0.85,
UP National Institutes of Health (UP-NIH),2020-05-10,286,260,45,215,,,4496,,6988,6678,1004,5674,0.15,0.85,
UP National Institutes of Health (UP-NIH),2020-05-11,290,281,32,249,,,4376,,7278,6959,1036,5923,0.15,0.85,
UP National Institutes of Health (UP-NIH),2020-05-12,169,139,22,117,,,4137,,7447,7098,1058,6040,0.15,0.85,
UP National Institutes of Health (UP-NIH),2020-05-13,178,109,32,77,,,3959,,7625,7207,1090,6117,0.15,0.85,
UP National Institutes of Health (UP-NIH),2020-05-14,232,204,23,181,,,3715,,7857,7411,1113,6298,0.15,0.85,
UP National Institutes of Health (UP-NIH),2020-05-15,164,151,14,137,,,7638,,8021,7562,1127,6435,0.15,0.85,
UP National Institutes of Health (UP-NIH),2020-05-16,212,149,21,128,0,0,7408,,8233,7711,1148,6563,0.15,0.85,
UP National Institutes of Health (UP-NIH),2020-05-17,144,108,12,96,0,0,7249,,8377,7819,1160,6659,0.15,0.85,
UP National Institutes of Health (UP-NIH),2020-05-18,120,91,16,75,0,0,7114,,8497,7910,1176,6734,0.15,0.85,
UP National Institutes of Health (UP-NIH),2020-05-19,144,114,25,89,4,2,6949,626,8641,8024,1201,6823,0.15,0.85,
UP National Institutes of Health (UP-NIH),2020-05-20,144,123,22,101,4,7,6787,816,8785,8147,1223,6924,0.15,0.85,
UP National Institutes of Health (UP-NIH),2020-05-21,120,99,13,86,2,8,6652,696,8905,8246,1236,7010,0.15,0.85,
UP National Institutes of Health (UP-NIH),2020-05-22,140,102,27,75,1,20,6512,556,9045,8348,1263,7085,0.15,0.85,
UP National Institutes of Health (UP-NIH),2020-05-23,174,158,31,127,9,6,6466,382,9219,8506,1294,7212,0.15,0.85,
UP National Institutes of Health (UP-NIH),2020-05-24,48,46,1,45,2,0,6412,334,9267,8552,1295,7257,0.15,0.85,
UP National Institutes of Health (UP-NIH),2020-05-25,120,96,16,80,10,14,6280,214,9387,8648,1311,7337,0.15,0.85,
UP National Institutes of Health (UP-NIH),2020-05-26,216,186,38,148,20,10,6049,0,9603,8834,1349,7485,0.15,0.85,
UP National Institutes of Health (UP-NIH),2020-05-27,144,136,22,114,4,4,6005,0,9747,8970,1371,7599,0.15,0.85,
UP National Institutes of Health (UP-NIH),2020-05-28,96,88,10,78,5,3,5787,0,9843,9058,1381,7677,0.15,0.85,
UP National Institutes of Health (UP-NIH),2020-05-29,144,122,13,109,3,2,5631,0,9987,9180,1394,7786,0.15,0.85,
UP National Institutes of Health (UP-NIH),2020-05-30,192,164,14,150,0,9,5427,0,10179,9344,1408,7936,0.15,0.85,
UP National Institutes of Health (UP-NIH),2020-05-31,96,94,5,89,1,1,5337,0,10275,9438,1413,8025,0.15,0.85,
UP National Institutes of Health (UP-NIH),2020-06-01,96,88,12,76,8,0,5235,0,10371,9526,1425,8101,0.15,0.85,
UP National Institutes of Health (UP-NIH),2020-06-02,96,77,10,67,16,1,5133,0,10467,9603,1435,8168,0.15,0.85,
UP National Institutes of Health (UP-NIH),2020-06-03,192,184,11,173,2,6,4929,0,10659,9787,1446,8341,0.15,0.85,
UP National Institutes of Health (UP-NIH),2020-06-04,144,133,9,124,2,9,24176,0,10803,9920,1455,8465,0.15,0.85,
UP National Institutes of Health (UP-NIH),2020-06-05,144,115,6,109,7,5,24023,0,10947,10035,1461,8574,0.15,0.85,
UP National Institutes of Health (UP-NIH),2020-06-06,96,79,6,73,8,4,23921,0,11043,10114,1467,8647,0.15,0.85,
UP National Institutes of Health (UP-NIH),2020-06-07,192,161,6,155,11,13,23669,0,11235,10275,1473,8802,0.14,0.86,
UP National Institutes of Health (UP-NIH),2020-06-08,200,174,15,159,17,9,23417,0,11435,10449,1488,8961,0.14,0.86,
UP National Institutes of Health (UP-NIH),2020-06-09,167,143,46,97,22,2,23247,0,11602,10592,1534,9058,0.14,0.86,
UP National Institutes of Health (UP-NIH),2020-06-10,143,126,10,116,8,9,23092,0,11745,10718,1544,9174,0.14,0.86,
UP National Institutes of Health (UP-NIH),2020-06-11,48,43,5,38,1,4,23040,88,11793,10761,1549,9212,0.14,0.86,
UP National Institutes of Health (UP-NIH),2020-06-12,131,122,9,113,5,5,22673,0,11924,10883,1558,9325,0.14,0.86,
UP National Institutes of Health (UP-NIH),2020-06-13,96,87,10,77,4,5,22523,0,12020,10970,1568,9402,0.14,0.86,
UP National Institutes of Health (UP-NIH),2020-06-14,60,57,2,55,2,1,22437,0,12080,11027,1570,9457,0.14,0.86,
UP National Institutes of Health (UP-NIH),2020-06-15,96,84,1,83,2,10,22120,0,12176,11111,1571,9540,0.14,0.86,
UP National Institutes of Health (UP-NIH),2020-06-16,96,84,1,83,2,10,22120,0,12272,11195,1572,9623,0.14,0.86,
UP National Institutes of Health (UP-NIH),2020-06-17,132,131,8,123,1,0,21976,0,12404,11326,1580,9746,0.14,0.86,
UP National Institutes of Health (UP-NIH),2020-06-18,144,114,1,113,11,19,21772,0,12548,11440,1581,9859,0.14,0.86,
UP National Institutes of Health (UP-NIH),2020-06-19,144,133,1,132,2,0,21616,0,12692,11573,1582,9991,0.14,0.86,
UP National Institutes of Health (UP-NIH),2020-06-20,158,135,5,130,3,0,21446,0,12850,11708,1587,10121,0.14,0.86,
UP National Institutes of Health (UP-NIH),2020-06-21,143,124,6,118,4,1,21291,0,12993,11832,1593,10239,0.13,0.87,
UP National Institutes of Health (UP-NIH),2020-06-22,96,88,5,83,4,1,21187,0,13089,11920,1598,10322,0.13,0.87,
UP National Institutes of Health (UP-NIH),2020-06-23,144,134,9,125,8,0,21031,0,13233,12054,1607,10447,0.13,0.87,
UP National Institutes of Health (UP-NIH),2020-06-24,144,134,4,130,9,0,20869,0,13377,12188,1611,10577,0.13,0.87,
UP National Institutes of Health (UP-NIH),2020-06-25,144,127,4,123,5,0,20713,0,13521,12315,1615,10700,0.13,0.87,
UP National Institutes of Health (UP-NIH),2020-06-26,144,138,8,130,5,0,20557,0,13665,12453,1623,10830,0.13,0.87,
UP National Institutes of Health (UP-NIH),2020-06-27,157,124,3,121,4,0,20388,0,13822,12577,1626,10951,0.13,0.87,
UP Philippine Genome Center,2020-05-01,41,41,4,37,,,1609,,44,44,3,41,0.07,0.93,
UP Philippine Genome Center,2020-05-02,0,0,0,0,,,1609,,44,44,3,41,0.07,0.93,
UP Philippine Genome Center,2020-05-03,0,0,0,0,,,1609,,44,44,3,41,0.07,0.93,
UP Philippine Genome Center,2020-05-04,80,80,4,76,,,1529,,124,124,7,117,0.06,0.94,
UP Philippine Genome Center,2020-05-05,3,2,0,2,,,1526,,127,126,7,119,0.06,0.94,
UP Philippine Genome Center,2020-05-06,61,61,4,57,,,1465,,188,187,11,176,0.06,0.94,
UP Philippine Genome Center,2020-05-07,79,76,5,71,,,7388,,267,263,16,247,0.06,0.94,
UP Philippine Genome Center,2020-05-08,0,0,0,0,,,7388,,267,263,16,247,0.06,0.94,
UP Philippine Genome Center,2020-05-09,43,43,22,21,,,7211,,310,306,38,268,0.12,0.88,
UP Philippine Genome Center,2020-05-10,8,8,0,8,,,7211,,318,314,38,276,0.12,0.88,
UP Philippine Genome Center,2020-05-11,8,0,0,0,,,7104,,326,314,38,276,0.12,0.88,
UP Philippine Genome Center,2020-05-12,0,0,0,0,,,7000,,326,314,38,276,0.12,0.88,
UP Philippine Genome Center,2020-05-13,108,108,16,92,,,7000,,434,422,54,368,0.13,0.87,
UP Philippine Genome Center,2020-05-14,71,71,20,51,,,6900,,505,493,74,419,0.15,0.85,
UP Philippine Genome Center,2020-05-15,208,208,17,191,,,6750,,713,701,91,610,0.13,0.87,
UP Philippine Genome Center,2020-05-16,108,108,15,93,0,0,6700,,821,809,106,703,0.13,0.87,
UP Philippine Genome Center,2020-05-17,0,0,0,0,0,0,6700,,821,809,106,703,0.13,0.87,
UP Philippine Genome Center,2020-05-18,0,0,0,0,0,0,6600,,821,809,106,703,0.13,0.87,
UP Philippine Genome Center,2020-05-19,92,63,10,53,0,29,6500,497,913,872,116,756,0.13,0.87,
UP Philippine Genome Center,2020-05-20,78,51,12,39,0,27,6500,56,991,923,128,795,0.14,0.86,
UP Philippine Genome Center,2020-05-21,141,60,14,46,0,81,14294,0,1132,983,142,841,0.14,0.86,
UP Philippine Genome Center,2020-05-22,415,395,103,292,0,20,9000,0,1547,1378,245,1133,0.18,0.82,
UP Philippine Genome Center,2020-05-23,327,326,50,276,0,1,8700,0,1874,1704,295,1409,0.17,0.83,
UP Philippine Genome Center,2020-05-24,0,0,0,0,0,0,8700,0,1874,1704,295,1409,0.17,0.83,
UP Philippine Genome Center,2020-05-25,0,0,0,0,0,0,8700,0,1874,1704,295,1409,0.17,0.83,
UP Philippine Genome Center,2020-05-26,72,72,6,66,0,0,8628,0,1946,1776,301,1475,0.17,0.83,
UP Philippine Genome Center,2020-05-27,225,225,23,202,0,0,7300,0,2171,2001,324,1677,0.16,0.84,
UP Philippine Genome Center,2020-05-28,175,175,12,163,0,0,7125,0,2346,2176,336,1840,0.15,0.85,
UP Philippine Genome Center,2020-05-29,208,208,34,174,0,0,6917,0,2554,2384,370,2014,0.16,0.84,
UP Philippine Genome Center,2020-05-30,281,281,49,232,0,0,6636,39,2835,2665,419,2246,0.16,0.84,
UP Philippine Genome Center,2020-05-31,0,0,0,0,0,0,6636,39,2835,2665,419,2246,0.16,0.84,
UP Philippine Genome Center,2020-06-01,0,0,0,0,0,0,6636,0,2835,2665,419,2246,0.16,0.84,
UP Philippine Genome Center,2020-06-02,269,269,37,232,0,0,6332,0,3104,2934,456,2478,0.16,0.84,
UP Philippine Genome Center,2020-06-03,241,241,19,222,0,0,5985,0,3345,3175,475,2700,0.15,0.85,
UP Philippine Genome Center,2020-06-04,157,157,7,150,0,0,5828,0,3502,3332,482,2850,0.14,0.86,
UP Philippine Genome Center,2020-06-05,282,282,35,247,0,0,5546,0,3784,3614,517,3097,0.14,0.86,
UP Philippine Genome Center,2020-06-06,197,197,23,174,0,0,5484,0,3981,3811,540,3271,0.14,0.86,
UP Philippine Genome Center,2020-06-07,0,0,0,0,0,0,5484,0,3981,3811,540,3271,0.14,0.86,
UP Philippine Genome Center,2020-06-08,0,0,0,0,0,0,5482,0,3981,3811,540,3271,0.14,0.86,
UP Philippine Genome Center,2020-06-09,185,185,17,168,0,0,5247,0,4166,3996,557,3439,0.14,0.86,
UP Philippine Genome Center,2020-06-10,196,196,20,176,0,0,5051,0,4362,4192,577,3615,0.14,0.86,
UP Philippine Genome Center,2020-06-11,167,167,21,146,0,0,4884,0,4529,4359,598,3761,0.14,0.86,
UP Philippine Genome Center,2020-06-12,202,201,25,176,0,1,5682,0,4731,4560,623,3937,0.14,0.86,
UP Philippine Genome Center,2020-06-13,215,215,27,188,0,0,4467,0,4946,4775,650,4125,0.14,0.86,
UP Philippine Genome Center,2020-06-14,0,0,0,0,0,0,4467,0,4946,4775,650,4125,0.14,0.86,
UP Philippine Genome Center,2020-06-15,0,0,0,0,0,0,4467,0,4946,4775,650,4125,0.14,0.86,
UP Philippine Genome Center,2020-06-16,131,131,61,70,0,0,4252,0,5077,4906,711,4195,0.14,0.86,
UP Philippine Genome Center,2020-06-17,334,334,163,171,0,0,3834,0,5411,5240,874,4366,0.17,0.83,
UP Philippine Genome Center,2020-06-18,0,0,0,0,0,0,3834,0,5411,5240,874,4366,0.17,0.83,
UP Philippine Genome Center,2020-06-19,262,262,74,188,0,0,3572,0,5673,5502,948,4554,0.17,0.83,
UP Philippine Genome Center,2020-06-20,0,0,0,0,0,0,3572,737,5673,5502,948,4554,0.17,0.83,
UP Philippine Genome Center,2020-06-21,258,258,101,157,0,0,6458,484,5931,5760,1049,4711,0.18,0.82,
UP Philippine Genome Center,2020-06-22,485,485,137,348,0,0,5973,0,6416,6245,1186,5059,0.19,0.81,
UP Philippine Genome Center,2020-06-23,0,0,0,0,0,0,5973,0,6416,6245,1186,5059,0.19,0.81,
UP Philippine Genome Center,2020-06-24,288,287,70,217,0,1,5685,0,6704,6532,1256,5276,0.19,0.81,
UP Philippine Genome Center,2020-06-25,355,354,68,286,0,1,5330,0,7059,6886,1324,5562,0.19,0.81,
UP Philippine Genome Center,2020-06-26,279,279,63,216,0,0,5051,0,7338,7165,1387,5778,0.19,0.81,
UP Philippine Genome Center,2020-06-27,300,282,115,167,0,18,4751,106,7638,7447,1502,5945,0.2,0.8,
UP-PGH Molecular Laboratory,2020-05-07,26,26,0,26,,,35,,42,42,0,42,0.0,1.0,
UP-PGH Molecular Laboratory,2020-05-08,15,15,0,15,,,1000,,57,57,0,57,0.0,1.0,
UP-PGH Molecular Laboratory,2020-05-09,15,15,0,15,,,2035,,72,72,0,72,0.0,1.0,
UP-PGH Molecular Laboratory,2020-05-10,100,100,8,92,,,1935,,172,172,8,164,0.05,0.95,
UP-PGH Molecular Laboratory,2020-05-11,42,42,5,37,,,1893,,214,214,13,201,0.06,0.94,
UP-PGH Molecular Laboratory,2020-05-12,19,19,4,15,,,1851,,233,233,17,216,0.07,0.93,
UP-PGH Molecular Laboratory,2020-05-13,40,40,2,38,,,1813,,273,273,19,254,0.07,0.93,
UP-PGH Molecular Laboratory,2020-05-14,37,37,15,22,,,1753,,310,310,34,276,0.11,0.89,
UP-PGH Molecular Laboratory,2020-05-15,25,25,5,20,,,1687,,335,335,39,296,0.12,0.88,
UP-PGH Molecular Laboratory,2020-05-16,81,81,5,76,0,0,1647,,416,416,44,372,0.11,0.89,
UP-PGH Molecular Laboratory,2020-05-17,0,0,0,0,0,0,1647,,416,416,44,372,0.11,0.89,
UP-PGH Molecular Laboratory,2020-05-18,50,39,1,38,0,0,1568,,466,455,45,410,0.1,0.9,
UP-PGH Molecular Laboratory,2020-05-19,80,64,12,52,0,0,1454,0,546,519,57,462,0.11,0.89,
UP-PGH Molecular Laboratory,2020-05-20,85,74,3,71,0,0,1361,0,631,593,60,533,0.1,0.9,
UP-PGH Molecular Laboratory,2020-05-21,92,71,4,67,0,0,1267,0,723,664,64,600,0.1,0.9,
UP-PGH Molecular Laboratory,2020-05-22,58,56,5,51,0,0,1177,0,781,720,69,651,0.1,0.9,
UP-PGH Molecular Laboratory,2020-05-23,222,214,28,186,0,0,962,13,1003,934,97,837,0.1,0.9,
UP-PGH Molecular Laboratory,2020-05-24,0,0,0,0,0,0,4080,0,1003,934,97,837,0.1,0.9,
UP-PGH Molecular Laboratory,2020-05-25,53,33,8,25,10,0,4012,0,1056,967,105,862,0.11,0.89,
UP-PGH Molecular Laboratory,2020-05-26,138,135,31,104,1,2,3847,0,1194,1102,136,966,0.12,0.88,
UP-PGH Molecular Laboratory,2020-05-27,141,118,37,81,0,0,3706,0,1335,1220,173,1047,0.14,0.86,
UP-PGH Molecular Laboratory,2020-05-28,120,104,7,97,0,0,3586,0,1455,1324,180,1144,0.14,0.86,
UP-PGH Molecular Laboratory,2020-05-29,109,84,18,66,0,0,3483,0,1564,1408,198,1210,0.14,0.86,
UP-PGH Molecular Laboratory,2020-05-30,139,137,51,86,0,0,3295,0,1703,1545,249,1296,0.16,0.84,
UP-PGH Molecular Laboratory,2020-05-31,0,0,0,0,0,0,3295,0,1703,1545,249,1296,0.16,0.84,
UP-PGH Molecular Laboratory,2020-06-01,136,109,7,102,0,0,3159,0,1839,1654,256,1398,0.15,0.85,
UP-PGH Molecular Laboratory,2020-06-02,168,168,9,159,0,0,2991,0,2007,1822,265,1557,0.15,0.85,
UP-PGH Molecular Laboratory,2020-06-03,195,190,10,180,0,0,2796,0,2202,2012,275,1737,0.14,0.86,
UP-PGH Molecular Laboratory,2020-06-04,179,172,1,171,0,0,2617,0,2381,2184,276,1908,0.13,0.87,
UP-PGH Molecular Laboratory,2020-06-05,212,210,4,206,0,0,2405,0,2593,2394,280,2114,0.12,0.88,
UP-PGH Molecular Laboratory,2020-06-06,543,537,8,529,0,0,1862,0,3136,2931,288,2643,0.1,0.9,
UP-PGH Molecular Laboratory,2020-06-07,239,229,1,228,0,0,1527,14,3375,3160,289,2871,0.09,0.91,
UP-PGH Molecular Laboratory,2020-06-08,282,282,16,266,0,0,1245,0,3657,3442,305,3137,0.09,0.91,
UP-PGH Molecular Laboratory,2020-06-09,282,281,24,257,0,1,963,0,3939,3723,329,3394,0.09,0.91,
UP-PGH Molecular Laboratory,2020-06-10,380,380,6,374,0,1,583,0,4319,4103,335,3768,0.08,0.92,
UP-PGH Molecular Laboratory,2020-06-11,192,180,13,167,12,1,391,136,4511,4283,348,3935,0.08,0.92,
UP-PGH Molecular Laboratory,2020-06-12,311,282,18,264,0,0,9600,0,4822,4565,366,4199,0.08,0.92,
UP-PGH Molecular Laboratory,2020-06-13,301,301,11,290,0,0,9299,0,5123,4866,377,4489,0.08,0.92,
UP-PGH Molecular Laboratory,2020-06-14,104,94,3,91,0,0,9193,0,5227,4960,380,4580,0.08,0.92,
UP-PGH Molecular Laboratory,2020-06-15,242,194,17,177,0,0,8951,0,5469,5154,397,4757,0.08,0.92,
UP-PGH Molecular Laboratory,2020-06-16,337,300,10,290,0,0,8614,0,5806,5454,407,5047,0.07,0.93,
UP-PGH Molecular Laboratory,2020-06-17,278,195,21,174,0,28,8336,0,6084,5649,428,5221,0.08,0.92,
UP-PGH Molecular Laboratory,2020-06-18,393,328,13,315,0,0,7943,0,6477,5977,441,5536,0.07,0.93,
UP-PGH Molecular Laboratory,2020-06-19,186,166,5,161,0,0,7757,0,6663,6143,446,5697,0.07,0.93,
UP-PGH Molecular Laboratory,2020-06-20,144,144,0,144,0,0,7613,0,6807,6287,446,5841,0.07,0.93,
UP-PGH Molecular Laboratory,2020-06-21,246,229,1,228,0,0,7367,0,7053,6516,447,6069,0.07,0.93,
UP-PGH Molecular Laboratory,2020-06-22,99,85,9,76,0,0,7268,0,7152,6601,456,6145,0.07,0.93,
UP-PGH Molecular Laboratory,2020-06-23,282,226,14,212,0,0,7006,0,7434,6827,470,6357,0.07,0.93,
UP-PGH Molecular Laboratory,2020-06-24,316,276,14,262,0,0,6690,0,7750,7103,484,6619,0.07,0.93,
UP-PGH Molecular Laboratory,2020-06-25,277,239,8,231,0,0,6413,0,8027,7342,492,6850,0.07,0.93,
UP-PGH Molecular Laboratory,2020-06-26,116,98,8,90,0,0,6295,0,8143,7440,500,6940,0.07,0.93,
UP-PGH Molecular Laboratory,2020-06-27,14,10,2,8,0,0,6281,0,8157,7450,502,6948,0.07,0.93,
Vicente Sotto Memorial Medical Center (VSMMC),2020-04-03,65,63,0,63,,,23716,,737,720,22,698,0.03,0.97,
Vicente Sotto Memorial Medical Center (VSMMC),2020-04-04,194,64,0,64,,,23620,,931,784,22,762,0.03,0.97,
Vicente Sotto Memorial Medical Center (VSMMC),2020-04-05,89,83,2,81,,,23524,,1020,867,24,843,0.03,0.97,
Vicente Sotto Memorial Medical Center (VSMMC),2020-04-06,86,84,1,83,,,23404,,1106,951,25,926,0.03,0.97,
Vicente Sotto Memorial Medical Center (VSMMC),2020-04-07,96,81,0,81,,,23284,,1202,1032,25,1007,0.02,0.98,
Vicente Sotto Memorial Medical Center (VSMMC),2020-04-08,67,63,0,63,,,23112,,1269,1095,25,1070,0.02,0.98,
Vicente Sotto Memorial Medical Center (VSMMC),2020-04-09,174,157,0,157,,,22896,,1443,1252,25,1227,0.02,0.98,
Vicente Sotto Memorial Medical Center (VSMMC),2020-04-10,62,50,0,50,,,22824,,1505,1302,25,1277,0.02,0.98,
Vicente Sotto Memorial Medical Center (VSMMC),2020-04-11,108,87,3,84,,,22608,,1613,1389,28,1361,0.02,0.98,
Vicente Sotto Memorial Medical Center (VSMMC),2020-04-12,17,10,0,10,,,22584,,1630,1399,28,1371,0.02,0.98,
Vicente Sotto Memorial Medical Center (VSMMC),2020-04-13,32,31,0,31,,,22488,,1662,1430,28,1402,0.02,0.98,
Vicente Sotto Memorial Medical Center (VSMMC),2020-04-14,130,102,7,95,,,22128,,1792,1532,35,1497,0.02,0.98,
Vicente Sotto Memorial Medical Center (VSMMC),2020-04-15,216,156,23,133,,,21984,,2008,1688,58,1630,0.03,0.97,
Vicente Sotto Memorial Medical Center (VSMMC),2020-04-16,237,223,28,195,,,21480,,2245,1911,86,1825,0.05,0.95,
Vicente Sotto Memorial Medical Center (VSMMC),2020-04-17,423,417,85,332,,,21072,,2668,2328,171,2157,0.07,0.93,
Vicente Sotto Memorial Medical Center (VSMMC),2020-04-18,256,245,7,238,,,20904,,2924,2573,178,2395,0.07,0.93,
Vicente Sotto Memorial Medical Center (VSMMC),2020-04-19,118,116,4,112,,,20736,,3042,2689,182,2507,0.07,0.93,
Vicente Sotto Memorial Medical Center (VSMMC),2020-04-20,207,201,2,199,,,20424,,3249,2890,184,2706,0.06,0.94,
Vicente Sotto Memorial Medical Center (VSMMC),2020-04-21,57,53,7,46,,,920,,3306,2943,191,2752,0.06,0.94,
Vicente Sotto Memorial Medical Center (VSMMC),2020-04-22,443,434,142,292,,,19700,,3749,3377,333,3044,0.1,0.9,
Vicente Sotto Memorial Medical Center (VSMMC),2020-04-23,356,346,20,326,,,19272,,4105,3723,353,3370,0.09,0.91,
Vicente Sotto Memorial Medical Center (VSMMC),2020-04-24,277,267,32,235,,,19000,,4382,3990,385,3605,0.1,0.9,
Vicente Sotto Memorial Medical Center (VSMMC),2020-04-25,124,123,63,60,,,18700,,4506,4113,448,3665,0.11,0.89,
Vicente Sotto Memorial Medical Center (VSMMC),2020-04-26,425,411,40,371,,,17900,,4931,4524,488,4036,0.11,0.89,
Vicente Sotto Memorial Medical Center (VSMMC),2020-04-27,499,465,37,428,,,17400,,5430,4989,525,4464,0.11,0.89,
Vicente Sotto Memorial Medical Center (VSMMC),2020-04-28,452,438,73,365,,,16800,,5882,5427,598,4829,0.11,0.89,
Vicente Sotto Memorial Medical Center (VSMMC),2020-04-29,471,455,36,419,,,16400,,6353,5882,634,5248,0.11,0.89,
Vicente Sotto Memorial Medical Center (VSMMC),2020-04-30,519,505,182,323,,,15800,,6872,6387,816,5571,0.13,0.87,
Vicente Sotto Memorial Medical Center (VSMMC),2020-05-01,513,503,50,453,,,15000,,7385,6890,866,6024,0.13,0.87,
Vicente Sotto Memorial Medical Center (VSMMC),2020-05-02,619,601,124,477,,,14200,,8004,7491,990,6501,0.13,0.87,
Vicente Sotto Memorial Medical Center (VSMMC),2020-05-03,700,679,92,587,,,13300,,8704,8170,1082,7088,0.13,0.87,
Vicente Sotto Memorial Medical Center (VSMMC),2020-05-04,538,528,187,341,,,12700,,9242,8698,1269,7429,0.15,0.85,
Vicente Sotto Memorial Medical Center (VSMMC),2020-05-05,613,605,191,414,,,10900,,9855,9303,1460,7843,0.16,0.84,
Vicente Sotto Memorial Medical Center (VSMMC),2020-05-06,555,536,120,416,,,10400,,10410,9839,1580,8259,0.16,0.84,
Vicente Sotto Memorial Medical Center (VSMMC),2020-05-07,515,501,30,471,,,9600,,10925,10340,1610,8730,0.16,0.84,
Vicente Sotto Memorial Medical Center (VSMMC),2020-05-08,531,486,26,460,,,8200,,11456,10826,1636,9190,0.15,0.85,
Vicente Sotto Memorial Medical Center (VSMMC),2020-05-09,627,608,57,551,,,8200,,12083,11434,1693,9741,0.15,0.85,
Vicente Sotto Memorial Medical Center (VSMMC),2020-05-10,664,637,104,533,,,7500,,12747,12071,1797,10274,0.15,0.85,
Vicente Sotto Memorial Medical Center (VSMMC),2020-05-11,702,641,104,537,,,6700,,13449,12712,1901,10811,0.15,0.85,
Vicente Sotto Memorial Medical Center (VSMMC),2020-05-12,523,495,42,453,,,5800,,13972,13207,1943,11264,0.15,0.85,
Vicente Sotto Memorial Medical Center (VSMMC),2020-05-13,266,238,17,221,,,5500,,14238,13445,1960,11485,0.15,0.85,
Vicente Sotto Memorial Medical Center (VSMMC),2020-05-14,88,67,3,64,,,5500,,14326,13512,1963,11549,0.15,0.85,
Vicente Sotto Memorial Medical Center (VSMMC),2020-05-15,28,18,1,17,,,10500,,14354,13530,1964,11566,0.15,0.85,
Vicente Sotto Memorial Medical Center (VSMMC),2020-05-16,0,0,0,0,0,0,10300,,14354,13530,1964,11566,0.15,0.85,
Vicente Sotto Memorial Medical Center (VSMMC),2020-05-17,69,63,8,55,0,0,8373,,14423,13593,1972,11621,0.15,0.85,
Vicente Sotto Memorial Medical Center (VSMMC),2020-05-18,196,188,17,171,0,0,9600,,14619,13781,1989,11792,0.14,0.86,
Vicente Sotto Memorial Medical Center (VSMMC),2020-05-19,255,221,41,180,0,4,9200,2539,14874,14002,2030,11972,0.14,0.86,
Vicente Sotto Memorial Medical Center (VSMMC),2020-05-20,216,185,77,108,5,0,8800,2315,15090,14187,2107,12080,0.15,0.85,
Vicente Sotto Memorial Medical Center (VSMMC),2020-05-21,241,219,56,163,3,0,13388,2173,15331,14406,2163,12243,0.15,0.85,
Vicente Sotto Memorial Medical Center (VSMMC),2020-05-22,179,163,23,140,0,0,12988,1739,15510,14569,2186,12383,0.15,0.85,
Vicente Sotto Memorial Medical Center (VSMMC),2020-05-23,172,96,0,96,1,0,12688,1040,15682,14665,2186,12479,0.15,0.85,
Vicente Sotto Memorial Medical Center (VSMMC),2020-05-24,263,186,22,164,0,0,11976,697,15945,14851,2208,12643,0.15,0.85,
Vicente Sotto Memorial Medical Center (VSMMC),2020-05-25,396,359,75,284,0,0,10140,674,16341,15210,2283,12927,0.15,0.85,
Vicente Sotto Memorial Medical Center (VSMMC),2020-05-26,447,304,26,278,1,0,9680,239,16788,15514,2309,13205,0.15,0.85,
Vicente Sotto Memorial Medical Center (VSMMC),2020-05-27,286,221,14,207,0,0,14676,0,17074,15735,2323,13412,0.15,0.85,
Vicente Sotto Memorial Medical Center (VSMMC),2020-05-28,367,114,16,98,0,0,14196,0,17441,15849,2339,13510,0.15,0.85,
Vicente Sotto Memorial Medical Center (VSMMC),2020-05-29,302,151,25,126,0,9,26764,9,17743,16000,2364,13636,0.15,0.85,
Vicente Sotto Memorial Medical Center (VSMMC),2020-05-30,332,277,62,215,1,0,25284,0,18075,16277,2426,13851,0.15,0.85,
Vicente Sotto Memorial Medical Center (VSMMC),2020-05-31,302,280,38,242,0,0,24516,0,18377,16557,2464,14093,0.15,0.85,
Vicente Sotto Memorial Medical Center (VSMMC),2020-06-01,472,412,77,335,0,0,24996,0,18849,16969,2541,14428,0.15,0.85,
Vicente Sotto Memorial Medical Center (VSMMC),2020-06-02,511,461,55,406,0,0,23748,0,19360,17430,2596,14834,0.15,0.85,
Vicente Sotto Memorial Medical Center (VSMMC),2020-06-03,537,503,92,411,2,0,23340,0,19897,17933,2688,15245,0.15,0.85,
Vicente Sotto Memorial Medical Center (VSMMC),2020-06-04,361,335,51,284,0,0,22764,0,20258,18268,2739,15529,0.15,0.85,
Vicente Sotto Memorial Medical Center (VSMMC),2020-06-05,241,198,52,146,0,0,22356,0,20499,18466,2791,15675,0.15,0.85,
Vicente Sotto Memorial Medical Center (VSMMC),2020-06-06,447,397,96,301,0,0,21876,0,20946,18863,2887,15976,0.15,0.85,
Vicente Sotto Memorial Medical Center (VSMMC),2020-06-07,484,426,105,321,0,0,21084,0,21430,19289,2992,16297,0.16,0.84,
Vicente Sotto Memorial Medical Center (VSMMC),2020-06-08,173,154,59,95,0,0,20748,0,21603,19443,3051,16392,0.16,0.84,
Vicente Sotto Memorial Medical Center (VSMMC),2020-06-09,265,225,87,138,0,0,20340,0,21868,19668,3138,16530,0.16,0.84,
Vicente Sotto Memorial Medical Center (VSMMC),2020-06-10,242,202,66,136,0,0,20124,0,22110,19870,3204,16666,0.16,0.84,
Vicente Sotto Memorial Medical Center (VSMMC),2020-06-11,167,134,44,90,0,0,19740,0,22277,20004,3248,16756,0.16,0.84,
Vicente Sotto Memorial Medical Center (VSMMC),2020-06-12,246,225,83,142,0,0,19620,0,22523,20229,3331,16898,0.16,0.84,
Vicente Sotto Memorial Medical Center (VSMMC),2020-06-13,237,205,75,130,0,0,18804,0,22760,20434,3406,17028,0.17,0.83,
Vicente Sotto Memorial Medical Center (VSMMC),2020-06-14,254,239,89,150,2,0,7680,0,23014,20673,3495,17178,0.17,0.83,
Vicente Sotto Memorial Medical Center (VSMMC),2020-06-15,226,213,72,141,2,0,18732,0,23240,20886,3567,17319,0.17,0.83,
Vicente Sotto Memorial Medical Center (VSMMC),2020-06-16,329,290,128,162,0,0,18348,0,23569,21176,3695,17481,0.17,0.83,
Vicente Sotto Memorial Medical Center (VSMMC),2020-06-17,235,201,107,94,0,0,50844,0,23804,21377,3802,17575,0.18,0.82,
Vicente Sotto Memorial Medical Center (VSMMC),2020-06-18,423,382,135,247,1,0,63020,0,24227,21759,3937,17822,0.18,0.82,
Vicente Sotto Memorial Medical Center (VSMMC),2020-06-19,138,103,52,51,0,0,62852,0,24365,21862,3989,17873,0.18,0.82,
Vicente Sotto Memorial Medical Center (VSMMC),2020-06-20,303,259,130,129,0,1,62444,0,24668,22121,4119,18002,0.19,0.81,
Vicente Sotto Memorial Medical Center (VSMMC),2020-06-21,250,214,101,113,2,0,61964,13,24918,22335,4220,18115,0.19,0.81,
Vicente Sotto Memorial Medical Center (VSMMC),2020-06-22,296,249,102,147,0,0,60948,0,25214,22584,4322,18262,0.19,0.81,
Vicente Sotto Memorial Medical Center (VSMMC),2020-06-23,290,264,108,156,0,0,60588,10,25504,22848,4430,18418,0.19,0.81,
Vicente Sotto Memorial Medical Center (VSMMC),2020-06-24,274,233,116,117,0,0,75204,104,25778,23081,4546,18535,0.2,0.8,
Vicente Sotto Memorial Medical Center (VSMMC),2020-06-25,308,252,113,139,0,0,74748,110,26086,23333,4659,18674,0.2,0.8,
Vicente Sotto Memorial Medical Center (VSMMC),2020-06-26,240,204,102,102,0,0,74292,124,26326,23537,4761,18776,0.2,0.8,
Vicente Sotto Memorial Medical Center (VSMMC),2020-06-27,336,281,157,124,0,1,73716,195,26662,23818,4918,18900,0.21,0.79,
Victoriano Luna - AFRIMS,2020-04-15,41,41,0,41,,,9956,,41,41,0,41,0.0,1.0,
Victoriano Luna - AFRIMS,2020-04-16,20,20,1,19,,,9932,,61,61,1,60,0.02,0.98,
Victoriano Luna - AFRIMS,2020-04-17,24,24,0,24,,,9903,,85,85,1,84,0.01,0.99,
Victoriano Luna - AFRIMS,2020-04-18,16,16,0,16,,,9881,,101,101,1,100,0.01,0.99,
Victoriano Luna - AFRIMS,2020-04-19,0,0,0,0,,,9881,,101,101,1,100,0.01,0.99,
Victoriano Luna - AFRIMS,2020-04-20,14,13,1,12,,,9861,,115,114,2,112,0.02,0.98,
Victoriano Luna - AFRIMS,2020-04-21,29,25,1,24,,,9825,,144,139,3,136,0.02,0.98,
Victoriano Luna - AFRIMS,2020-04-22,31,31,0,31,,,9786,,175,170,3,167,0.02,0.98,
Victoriano Luna - AFRIMS,2020-04-23,40,35,0,35,,,9739,,215,205,3,202,0.01,0.99,
Victoriano Luna - AFRIMS,2020-04-24,50,49,0,49,,,9683,,265,254,3,251,0.01,0.99,
Victoriano Luna - AFRIMS,2020-04-25,56,55,0,55,,,9619,,321,309,3,306,0.01,0.99,
Victoriano Luna - AFRIMS,2020-04-26,0,0,0,0,,,9619,,321,309,3,306,0.01,0.99,
Victoriano Luna - AFRIMS,2020-04-27,50,49,0,49,,,9563,,371,358,3,355,0.01,0.99,
Victoriano Luna - AFRIMS,2020-04-28,50,44,1,43,,,9500,,421,402,4,398,0.01,0.99,
Victoriano Luna - AFRIMS,2020-04-29,50,49,0,49,,,9442,,471,451,4,447,0.01,0.99,
Victoriano Luna - AFRIMS,2020-04-30,53,53,0,53,,,9382,,524,504,4,500,0.01,0.99,
Victoriano Luna - AFRIMS,2020-05-01,60,60,0,60,,,9318,,584,564,4,560,0.01,0.99,
Victoriano Luna - AFRIMS,2020-05-02,60,59,0,59,,,9250,,644,623,4,619,0.01,0.99,
Victoriano Luna - AFRIMS,2020-05-03,41,41,0,41,,,9202,,685,664,4,660,0.01,0.99,
Victoriano Luna - AFRIMS,2020-05-04,68,63,1,62,,,9126,,753,727,5,722,0.01,0.99,
Victoriano Luna - AFRIMS,2020-05-05,50,48,0,48,,,9068,,803,775,5,770,0.01,0.99,
Victoriano Luna - AFRIMS,2020-05-06,60,60,0,60,,,9000,,863,835,5,830,0.01,0.99,
Victoriano Luna - AFRIMS,2020-05-07,64,64,2,62,,,8928,,927,899,7,892,0.01,0.99,
Victoriano Luna - AFRIMS,2020-05-08,48,48,0,48,,,8872,,975,947,7,940,0.01,0.99,
Victoriano Luna - AFRIMS,2020-05-09,49,49,0,49,,,8816,,1024,996,7,989,0.01,0.99,
Victoriano Luna - AFRIMS,2020-05-10,21,21,0,21,,,8791,,1045,1017,7,1010,0.01,0.99,
Victoriano Luna - AFRIMS,2020-05-11,39,38,0,38,,,8744,,1084,1055,7,1048,0.01,0.99,
Victoriano Luna - AFRIMS,2020-05-12,43,43,0,43,,,8695,,1127,1098,7,1091,0.01,0.99,
Victoriano Luna - AFRIMS,2020-05-13,48,46,0,46,,,8639,,1175,1144,7,1137,0.01,0.99,
Victoriano Luna - AFRIMS,2020-05-14,33,32,0,32,,,8598,,1208,1176,7,1169,0.01,0.99,
Victoriano Luna - AFRIMS,2020-05-15,44,42,5,37,,,8438,,1252,1218,12,1206,0.01,0.99,
Victoriano Luna - AFRIMS,2020-05-16,56,55,0,55,0,0,8373,,1308,1273,12,1261,0.01,0.99,
Victoriano Luna - AFRIMS,2020-05-17,0,0,0,0,0,0,10200,,1308,1273,12,1261,0.01,0.99,
Victoriano Luna - AFRIMS,2020-05-18,61,61,0,61,0,0,8303,,1369,1334,12,1322,0.01,0.99,
Victoriano Luna - AFRIMS,2020-05-19,51,51,0,51,0,0,8242,0,1420,1385,12,1373,0.01,0.99,
Victoriano Luna - AFRIMS,2020-05-20,29,29,0,29,0,0,8194,0,1449,1414,12,1402,0.01,0.99,
Victoriano Luna - AFRIMS,2020-05-21,31,31,0,31,0,0,8154,0,1480,1445,12,1433,0.01,0.99,
Victoriano Luna - AFRIMS,2020-05-22,36,36,0,36,0,0,8109,0,1516,1481,12,1469,0.01,0.99,
Victoriano Luna - AFRIMS,2020-05-23,29,29,0,29,0,0,8071,0,1545,1510,12,1498,0.01,0.99,
Victoriano Luna - AFRIMS,2020-05-24,27,27,0,27,0,0,8035,0,1572,1537,12,1525,0.01,0.99,
Victoriano Luna - AFRIMS,2020-05-25,22,22,0,22,0,0,8004,0,1594,1559,12,1547,0.01,0.99,
Victoriano Luna - AFRIMS,2020-05-26,29,29,0,29,0,0,7966,0,1623,1588,12,1576,0.01,0.99,
Victoriano Luna - AFRIMS,2020-05-27,33,33,0,33,0,0,7924,0,1656,1621,12,1609,0.01,0.99,
Victoriano Luna - AFRIMS,2020-05-28,79,79,0,79,0,0,7835,0,1735,1700,12,1688,0.01,0.99,
Victoriano Luna - AFRIMS,2020-05-29,46,46,1,45,0,0,7778,0,1781,1746,13,1733,0.01,0.99,
Victoriano Luna - AFRIMS,2020-05-30,43,43,0,43,0,0,7724,0,1824,1789,13,1776,0.01,0.99,
Victoriano Luna - AFRIMS,2020-05-31,36,36,0,36,0,0,7677,0,1860,1825,13,1812,0.01,0.99,
Victoriano Luna - AFRIMS,2020-06-01,64,64,0,64,0,0,7602,0,1924,1889,13,1876,0.01,0.99,
Victoriano Luna - AFRIMS,2020-06-02,71,71,0,71,0,0,7520,0,1995,1960,13,1947,0.01,0.99,
Victoriano Luna - AFRIMS,2020-06-03,80,76,0,76,0,0,7428,0,2075,2036,13,2023,0.01,0.99,
Victoriano Luna - AFRIMS,2020-06-04,80,69,0,69,0,0,7336,0,2155,2105,13,2092,0.01,0.99,
Victoriano Luna - AFRIMS,2020-06-05,65,64,0,64,0,0,7260,0,2220,2169,13,2156,0.01,0.99,
Victoriano Luna - AFRIMS,2020-06-06,,,,,,,,,2220,2169,13,2156,0.01,0.99,
Victoriano Luna - AFRIMS,2020-06-07,25,25,0,25,0,0,7226,0,2245,2194,13,2181,0.01,0.99,
Victoriano Luna - AFRIMS,2020-06-08,25,23,0,23,0,0,0,0,2270,2217,13,2204,0.01,0.99,
Victoriano Luna - AFRIMS,2020-06-09,25,24,1,23,0,0,7192,0,2295,2241,14,2227,0.01,0.99,
Victoriano Luna - AFRIMS,2020-06-10,34,34,1,33,0,0,7149,0,2329,2275,15,2260,0.01,0.99,
Victoriano Luna - AFRIMS,2020-06-11,25,24,1,23,0,0,7115,0,2354,2299,16,2283,0.01,0.99,
Victoriano Luna - AFRIMS,2020-06-12,29,28,0,28,0,0,7077,0,2383,2327,16,2311,0.01,0.99,
Victoriano Luna - AFRIMS,2020-06-13,31,31,0,31,0,0,7037,0,2414,2358,16,2342,0.01,0.99,
Victoriano Luna - AFRIMS,2020-06-14,29,29,0,29,0,0,6099,0,2443,2387,16,2371,0.01,0.99,
Victoriano Luna - AFRIMS,2020-06-15,26,25,0,25,0,0,6964,0,2469,2412,16,2396,0.01,0.99,
Victoriano Luna - AFRIMS,2020-06-16,47,47,0,47,0,0,6905,0,2516,2459,16,2443,0.01,0.99,
Victoriano Luna - AFRIMS,2020-06-17,48,47,1,46,0,0,6844,0,2564,2506,17,2489,0.01,0.99,
Victoriano Luna - AFRIMS,2020-06-18,46,43,2,41,0,0,6784,0,2610,2549,19,2530,0.01,0.99,
Victoriano Luna - AFRIMS,2020-06-19,36,10,0,10,0,0,6739,0,2646,2559,19,2540,0.01,0.99,
Victoriano Luna - AFRIMS,2020-06-20,41,41,0,41,0,0,6687,0,2687,2600,19,2581,0.01,0.99,
Victoriano Luna - AFRIMS,2020-06-21,27,27,0,27,0,0,6649,0,2714,2627,19,2608,0.01,0.99,
Victoriano Luna - AFRIMS,2020-06-22,33,32,1,31,0,0,6608,0,2747,2659,20,2639,0.01,0.99,
Victoriano Luna - AFRIMS,2020-06-23,82,75,2,73,0,0,6514,0,2829,2734,22,2712,0.01,0.99,
Victoriano Luna - AFRIMS,2020-06-24,96,95,0,95,0,0,6403,0,2925,2829,22,2807,0.01,0.99,
Victoriano Luna - AFRIMS,2020-06-25,134,132,1,131,0,0,6255,0,3059,2961,23,2938,0.01,0.99,
Victoriano Luna - AFRIMS,2020-06-26,63,62,1,61,0,0,6551,0,3122,3023,24,2999,0.01,0.99,
Victoriano Luna - AFRIMS,2020-06-27,75,74,1,73,0,0,6461,0,3197,3097,25,3072,0.01,0.99,
Western Visayas Medical Center (WVMC),2020-04-03,98,98,0,98,,,4368,,494,467,31,436,0.07,0.93,
Western Visayas Medical Center (WVMC),2020-04-04,184,183,1,182,,,4152,,678,650,32,618,0.05,0.95,
Western Visayas Medical Center (WVMC),2020-04-05,103,103,1,102,,,4032,,781,753,33,720,0.04,0.96,
Western Visayas Medical Center (WVMC),2020-04-06,19,19,2,17,,,4032,,800,772,35,737,0.05,0.95,
Western Visayas Medical Center (WVMC),2020-04-07,112,112,1,111,,,3888,,912,884,36,848,0.04,0.96,
Western Visayas Medical Center (WVMC),2020-04-08,148,54,0,54,,,3600,,1060,938,36,902,0.04,0.96,
Western Visayas Medical Center (WVMC),2020-04-09,247,245,0,245,,,3432,,1307,1183,36,1147,0.03,0.97,
Western Visayas Medical Center (WVMC),2020-04-10,0,0,0,0,,,3432,,1307,1183,36,1147,0.03,0.97,
Western Visayas Medical Center (WVMC),2020-04-11,103,99,0,99,,,3432,,1410,1282,36,1246,0.03,0.97,
Western Visayas Medical Center (WVMC),2020-04-12,107,97,1,96,,,3192,,1517,1379,37,1342,0.03,0.97,
Western Visayas Medical Center (WVMC),2020-04-13,0,0,0,0,,,3192,,1517,1379,37,1342,0.03,0.97,
Western Visayas Medical Center (WVMC),2020-04-14,89,43,0,43,,,3096,,1606,1422,37,1385,0.03,0.97,
Western Visayas Medical Center (WVMC),2020-04-15,52,50,2,48,,,3796,,1658,1472,39,1433,0.03,0.97,
Western Visayas Medical Center (WVMC),2020-04-16,171,72,5,67,,,3548,,1829,1544,44,1500,0.03,0.97,
Western Visayas Medical Center (WVMC),2020-04-17,100,79,1,78,,,3324,,1929,1623,45,1578,0.03,0.97,
Western Visayas Medical Center (WVMC),2020-04-18,241,240,4,236,,,3124,,2170,1863,49,1814,0.03,0.97,
Western Visayas Medical Center (WVMC),2020-04-19,42,40,0,40,,,3052,,2212,1903,49,1854,0.03,0.97,
Western Visayas Medical Center (WVMC),2020-04-20,85,80,0,80,,,2880,,2297,1983,49,1934,0.02,0.98,
Western Visayas Medical Center (WVMC),2020-04-21,178,164,2,162,,,2736,,2475,2147,51,2096,0.02,0.98,
Western Visayas Medical Center (WVMC),2020-04-22,277,243,3,240,,,2400,,2752,2390,54,2336,0.02,0.98,
Western Visayas Medical Center (WVMC),2020-04-23,111,95,0,95,,,2280,,2863,2485,54,2431,0.02,0.98,
Western Visayas Medical Center (WVMC),2020-04-24,140,134,0,134,,,2088,,3003,2619,54,2565,0.02,0.98,
Western Visayas Medical Center (WVMC),2020-04-25,193,186,5,181,,,1848,,3196,2805,59,2746,0.02,0.98,
Western Visayas Medical Center (WVMC),2020-04-26,131,129,1,128,,,1752,,3327,2934,60,2874,0.02,0.98,
Western Visayas Medical Center (WVMC),2020-04-27,0,0,0,0,,,1752,,3327,2934,60,2874,0.02,0.98,
Western Visayas Medical Center (WVMC),2020-04-28,287,287,3,284,,,1200,,3614,3221,63,3158,0.02,0.98,
Western Visayas Medical Center (WVMC),2020-04-29,268,261,0,261,,,2928,,3882,3482,63,3419,0.02,0.98,
Western Visayas Medical Center (WVMC),2020-04-30,248,241,0,241,,,2640,,4130,3723,63,3660,0.02,0.98,
Western Visayas Medical Center (WVMC),2020-05-01,262,232,6,226,,,2136,,4392,3955,69,3886,0.02,0.98,
Western Visayas Medical Center (WVMC),2020-05-02,275,243,0,243,,,1896,,4667,4198,69,4129,0.02,0.98,
Western Visayas Medical Center (WVMC),2020-05-03,425,289,1,288,,,1896,,5092,4487,70,4417,0.02,0.98,
Western Visayas Medical Center (WVMC),2020-05-04,460,374,8,366,,,792,,5552,4861,78,4783,0.02,0.98,
Western Visayas Medical Center (WVMC),2020-05-05,196,179,6,173,,,576,,5748,5040,84,4956,0.02,0.98,
Western Visayas Medical Center (WVMC),2020-05-06,254,248,6,242,,,264,,6002,5288,90,5198,0.02,0.98,
Western Visayas Medical Center (WVMC),2020-05-07,324,318,0,318,,,0,,6326,5606,90,5516,0.02,0.98,
Western Visayas Medical Center (WVMC),2020-05-08,251,248,1,247,,,0,,6577,5854,91,5763,0.02,0.98,
Western Visayas Medical Center (WVMC),2020-05-09,305,293,1,292,,,6000,,6882,6147,92,6055,0.01,0.99,
Western Visayas Medical Center (WVMC),2020-05-10,258,246,3,243,,,5520,,7140,6393,95,6298,0.01,0.99,
Western Visayas Medical Center (WVMC),2020-05-11,47,41,1,40,,,5448,,7187,6434,96,6338,0.01,0.99,
Western Visayas Medical Center (WVMC),2020-05-12,228,211,2,209,,,5136,,7415,6645,98,6547,0.01,0.99,
Western Visayas Medical Center (WVMC),2020-05-13,205,201,2,199,,,4824,,7620,6846,100,6746,0.01,0.99,
Western Visayas Medical Center (WVMC),2020-05-14,140,138,2,136,,,4584,,7760,6984,102,6882,0.01,0.99,
Western Visayas Medical Center (WVMC),2020-05-15,322,321,0,321,,,4200,,8082,7305,102,7203,0.01,0.99,
Western Visayas Medical Center (WVMC),2020-05-16,319,242,2,240,0,0,3816,,8401,7547,104,7443,0.01,0.99,
Western Visayas Medical Center (WVMC),2020-05-17,139,110,0,110,0,0,3672,,8540,7657,104,7553,0.01,0.99,
Western Visayas Medical Center (WVMC),2020-05-18,59,49,0,49,0,0,3408,,8599,7706,104,7602,0.01,0.99,
Western Visayas Medical Center (WVMC),2020-05-19,330,324,1,323,0,2,3072,0,8929,8030,105,7925,0.01,0.99,
Western Visayas Medical Center (WVMC),2020-05-20,313,313,0,313,0,10,7553,0,9242,8343,105,8238,0.01,0.99,
Western Visayas Medical Center (WVMC),2020-05-21,301,255,2,253,0,2,12048,0,9543,8598,107,8491,0.01,0.99,
Western Visayas Medical Center (WVMC),2020-05-22,227,214,0,214,0,14,11832,14,9770,8812,107,8705,0.01,0.99,
Western Visayas Medical Center (WVMC),2020-05-23,204,203,0,203,0,29,11592,29,9974,9015,107,8908,0.01,0.99,
Western Visayas Medical Center (WVMC),2020-05-24,287,280,1,279,0,3,11400,3,10261,9295,108,9187,0.01,0.99,
Western Visayas Medical Center (WVMC),2020-05-25,201,194,1,193,0,5,11160,5,10462,9489,109,9380,0.01,0.99,
Western Visayas Medical Center (WVMC),2020-05-26,66,55,0,55,0,5,11088,5,10528,9544,109,9435,0.01,0.99,
Western Visayas Medical Center (WVMC),2020-05-27,606,542,2,540,0,62,10272,62,11134,10086,111,9975,0.01,0.99,
Western Visayas Medical Center (WVMC),2020-05-28,57,54,2,52,0,3,10244,0,11191,10140,113,10027,0.01,0.99,
Western Visayas Medical Center (WVMC),2020-05-29,0,0,0,0,0,0,10224,1168,11191,10140,113,10027,0.01,0.99,
Western Visayas Medical Center (WVMC),2020-05-30,439,428,0,428,0,11,19696,505,11630,10568,113,10455,0.01,0.99,
Western Visayas Medical Center (WVMC),2020-05-31,527,494,2,492,0,12,22744,757,12157,11062,115,10947,0.01,0.99,
Western Visayas Medical Center (WVMC),2020-06-01,400,356,1,355,0,0,18496,570,12557,11418,116,11302,0.01,0.99,
Western Visayas Medical Center (WVMC),2020-06-02,303,280,2,278,0,10,18448,579,12860,11698,118,11580,0.01,0.99,
Western Visayas Medical Center (WVMC),2020-06-03,674,644,3,641,0,6,24554,661,13534,12342,121,12221,0.01,0.99,
Western Visayas Medical Center (WVMC),2020-06-04,304,301,2,299,0,6,24256,1025,13838,12643,123,12520,0.01,0.99,
Western Visayas Medical Center (WVMC),2020-06-05,402,388,0,388,0,13,23392,657,14240,13031,123,12908,0.01,0.99,
Western Visayas Medical Center (WVMC),2020-06-06,527,494,2,492,0,12,22744,757,14767,13525,125,13400,0.01,0.99,
Western Visayas Medical Center (WVMC),2020-06-07,588,332,0,332,0,65,21808,1225,15355,13857,125,13732,0.01,0.99,
Western Visayas Medical Center (WVMC),2020-06-08,229,222,2,220,0,7,21520,1247,15584,14079,127,13952,0.01,0.99,
Western Visayas Medical Center (WVMC),2020-06-09,529,414,2,412,0,16,20384,880,16113,14493,129,14364,0.01,0.99,
Western Visayas Medical Center (WVMC),2020-06-10,476,422,1,421,0,54,19984,1022,16589,14915,130,14785,0.01,0.99,
Western Visayas Medical Center (WVMC),2020-06-11,634,571,2,569,0,62,19384,830,17223,15486,132,15354,0.01,0.99,
Western Visayas Medical Center (WVMC),2020-06-12,347,321,2,319,0,26,18984,750,17570,15807,134,15673,0.01,0.99,
Western Visayas Medical Center (WVMC),2020-06-13,654,623,1,622,0,31,18284,1160,18224,16430,135,16295,0.01,0.99,
Western Visayas Medical Center (WVMC),2020-06-14,480,416,1,415,0,64,17784,361,18704,16846,136,16710,0.01,0.99,
Western Visayas Medical Center (WVMC),2020-06-15,714,647,3,644,0,35,17170,361,19418,17493,139,17354,0.01,0.99,
Western Visayas Medical Center (WVMC),2020-06-16,506,371,0,371,0,84,17712,150,19924,17864,139,17725,0.01,0.99,
Western Visayas Medical Center (WVMC),2020-06-17,754,602,7,595,0,40,16934,223,20678,18466,146,18320,0.01,0.99,
Western Visayas Medical Center (WVMC),2020-06-18,495,348,1,347,0,148,16338,739,21173,18814,147,18667,0.01,0.99,
Western Visayas Medical Center (WVMC),2020-06-19,1159,879,5,874,0,277,15148,963,22332,19693,152,19541,0.01,0.99,
Western Visayas Medical Center (WVMC),2020-06-20,463,420,2,418,0,40,14648,1295,22795,20113,154,19959,0.01,0.99,
Western Visayas Medical Center (WVMC),2020-06-21,673,587,10,577,0,86,14186,913,23468,20700,164,20536,0.01,0.99,
Western Visayas Medical Center (WVMC),2020-06-22,495,477,3,474,0,28,13186,1044,23963,21177,167,21010,0.01,0.99,
Western Visayas Medical Center (WVMC),2020-06-23,638,538,5,533,0,105,12340,954,24601,21715,172,21543,0.01,0.99,
Western Visayas Medical Center (WVMC),2020-06-24,861,830,4,826,0,30,11228,523,25462,22545,176,22369,0.01,0.99,
Western Visayas Medical Center (WVMC),2020-06-25,440,436,4,432,0,13,10348,651,25902,22981,180,22801,0.01,0.99,
Western Visayas Medical Center (WVMC),2020-06-26,541,515,5,510,0,25,9698,500,26443,23496,185,23311,0.01,0.99,
Western Visayas Medical Center (WVMC),2020-06-27,534,506,41,465,0,28,9328,1320,26977,24002,226,23776,0.01,0.99,
Zamboanga City Medical Center - DA Satellite Laboratory,2020-05-18,16,13,0,13,0,0,256,,16,13,0,13,0.0,1.0,
Zamboanga City Medical Center - DA Satellite Laboratory,2020-05-19,60,58,0,58,1,0,192,130,76,71,0,71,0.0,1.0,
Zamboanga City Medical Center - DA Satellite Laboratory,2020-05-20,70,67,0,67,2,0,120,60,146,138,0,138,0.0,1.0,
Zamboanga City Medical Center - DA Satellite Laboratory,2020-05-21,69,64,4,60,4,0,1968,8,215,202,4,198,0.02,0.98,
Zamboanga City Medical Center - DA Satellite Laboratory,2020-05-22,12,7,0,7,5,0,1956,7,227,209,4,205,0.02,0.98,
Zamboanga City Medical Center - DA Satellite Laboratory,2020-05-23,12,12,4,8,0,0,1944,0,239,221,8,213,0.04,0.96,
Zamboanga City Medical Center - DA Satellite Laboratory,2020-05-24,0,0,0,0,0,0,1944,0,239,221,8,213,0.04,0.96,
Zamboanga City Medical Center - DA Satellite Laboratory,2020-05-25,0,0,0,0,0,0,1944,0,239,221,8,213,0.04,0.96,
Zamboanga City Medical Center - DA Satellite Laboratory,2020-05-26,14,14,0,14,0,0,1930,0,253,235,8,227,0.03,0.97,
Zamboanga City Medical Center - DA Satellite Laboratory,2020-05-27,24,24,0,24,0,0,1904,0,277,259,8,251,0.03,0.97,
Zamboanga City Medical Center - DA Satellite Laboratory,2020-05-28,60,53,6,47,7,0,2342,148,337,312,14,298,0.04,0.96,
Zamboanga City Medical Center - DA Satellite Laboratory,2020-05-29,79,78,2,76,1,0,2261,53,416,390,16,374,0.04,0.96,
Zamboanga City Medical Center - DA Satellite Laboratory,2020-05-30,69,69,0,69,0,0,2210,0,485,459,16,443,0.03,0.97,
Zamboanga City Medical Center - DA Satellite Laboratory,2020-05-31,0,0,0,0,0,0,2210,0,485,459,16,443,0.03,0.97,
Zamboanga City Medical Center - DA Satellite Laboratory,2020-06-01,117,93,0,93,0,0,5067,24,602,552,16,536,0.03,0.97,
Zamboanga City Medical Center - DA Satellite Laboratory,2020-06-02,96,89,2,87,4,3,4848,1,698,641,18,623,0.03,0.97,
Zamboanga City Medical Center - DA Satellite Laboratory,2020-06-03,80,79,4,75,1,0,2092,42,778,720,22,698,0.03,0.97,
Zamboanga City Medical Center - DA Satellite Laboratory,2020-06-04,139,89,1,88,50,0,2044,0,917,809,23,786,0.03,0.97,
Zamboanga City Medical Center - DA Satellite Laboratory,2020-06-05,137,127,0,127,6,4,2027,0,1054,936,23,913,0.02,0.98,
Zamboanga City Medical Center - DA Satellite Laboratory,2020-06-06,185,178,0,178,2,5,4248,0,1239,1114,23,1091,0.02,0.98,
Zamboanga City Medical Center - DA Satellite Laboratory,2020-06-07,0,0,0,0,0,0,4248,0,1239,1114,23,1091,0.02,0.98,
Zamboanga City Medical Center - DA Satellite Laboratory,2020-06-08,24,24,1,23,0,0,4224,0,1263,1138,24,1114,0.02,0.98,
Zamboanga City Medical Center - DA Satellite Laboratory,2020-06-09,51,51,1,50,0,0,4173,0,1314,1189,25,1164,0.02,0.98,
Zamboanga City Medical Center - DA Satellite Laboratory,2020-06-10,71,71,1,70,0,0,4072,0,1385,1260,26,1234,0.02,0.98,
Zamboanga City Medical Center - DA Satellite Laboratory,2020-06-11,126,126,1,125,0,0,3946,0,1511,1386,27,1359,0.02,0.98,
Zamboanga City Medical Center - DA Satellite Laboratory,2020-06-12,0,0,0,0,0,0,3946,0,1511,1386,27,1359,0.02,0.98,
Zamboanga City Medical Center - DA Satellite Laboratory,2020-06-13,92,92,1,91,0,0,3360,0,1603,1478,28,1450,0.02,0.98,
Zamboanga City Medical Center - DA Satellite Laboratory,2020-06-14,185,185,1,184,0,0,3176,0,1788,1663,29,1634,0.02,0.98,
Zamboanga City Medical Center - DA Satellite Laboratory,2020-06-15,103,102,0,102,1,0,3145,1,1891,1765,29,1736,0.02,0.98,
Zamboanga City Medical Center - DA Satellite Laboratory,2020-06-16,92,92,3,89,0,0,3340,0,1983,1857,32,1825,0.02,0.98,
Zamboanga City Medical Center - DA Satellite Laboratory,2020-06-17,108,107,0,107,1,0,2880,0,2091,1964,32,1932,0.02,0.98,
Zamboanga City Medical Center - DA Satellite Laboratory,2020-06-18,53,53,1,52,0,0,3096,0,2144,2017,33,1984,0.02,0.98,
Zamboanga City Medical Center - DA Satellite Laboratory,2020-06-19,180,174,5,169,6,0,2880,0,2324,2191,38,2153,0.02,0.98,
Zamboanga City Medical Center - DA Satellite Laboratory,2020-06-20,8,8,0,8,0,0,3450,0,2332,2199,38,2161,0.02,0.98,
Zamboanga City Medical Center - DA Satellite Laboratory,2020-06-21,42,42,0,42,0,0,3407,0,2374,2241,38,2203,0.02,0.98,
Zamboanga City Medical Center - DA Satellite Laboratory,2020-06-22,0,0,0,0,0,0,3407,0,2374,2241,38,2203,0.02,0.98,
Zamboanga City Medical Center - DA Satellite Laboratory,2020-06-23,50,48,9,39,1,0,1433,0,2424,2289,47,2242,0.02,0.98,
Zamboanga City Medical Center - DA Satellite Laboratory,2020-06-24,89,88,1,87,1,0,8592,0,2513,2377,48,2329,0.02,0.98,
Zamboanga City Medical Center - DA Satellite Laboratory,2020-06-25,93,92,6,86,0,1,1431,0,2606,2469,54,2415,0.02,0.98,
Zamboanga City Medical Center - DA Satellite Laboratory,2020-06-26,184,184,8,176,0,0,8280,0,2790,2653,62,2591,0.02,0.98,
Zamboanga City Medical Center - DA Satellite Laboratory,2020-06-27,78,73,4,69,5,0,1352,0,2868,2726,66,2660,0.02,0.98,
Zamboanga City Medical Center GeneXpert Laboratory,2020-05-08,42,41,2,39,,,1055,,42,41,2,39,0.05,0.95,
Zamboanga City Medical Center GeneXpert Laboratory,2020-05-09,76,75,15,60,,,979,,118,116,17,99,0.15,0.85,
Zamboanga City Medical Center GeneXpert Laboratory,2020-05-10,0,0,0,0,,,979,,118,116,17,99,0.15,0.85,
Zamboanga City Medical Center GeneXpert Laboratory,2020-05-11,65,64,21,43,,,914,,183,180,38,142,0.21,0.79,
Zamboanga City Medical Center GeneXpert Laboratory,2020-05-12,72,72,13,59,,,842,,255,252,51,201,0.2,0.8,
Zamboanga City Medical Center GeneXpert Laboratory,2020-05-13,64,63,16,47,,,778,,319,315,67,248,0.21,0.79,
Zamboanga City Medical Center GeneXpert Laboratory,2020-05-14,88,86,11,75,,,690,,407,401,78,323,0.19,0.81,
Zamboanga City Medical Center GeneXpert Laboratory,2020-05-15,88,88,23,65,,,602,,495,489,101,388,0.21,0.79,
Zamboanga City Medical Center GeneXpert Laboratory,2020-05-16,49,49,1,48,0,0,553,,544,538,102,436,0.19,0.81,
Zamboanga City Medical Center GeneXpert Laboratory,2020-05-17,7,7,0,7,0,0,546,,551,545,102,443,0.19,0.81,
Zamboanga City Medical Center GeneXpert Laboratory,2020-05-18,23,23,0,23,0,0,523,,574,568,102,466,0.18,0.82,
Zamboanga City Medical Center GeneXpert Laboratory,2020-05-19,29,29,2,27,0,0,493,0,603,597,104,493,0.17,0.83,
Zamboanga City Medical Center GeneXpert Laboratory,2020-05-20,46,46,12,34,0,0,446,0,649,643,116,527,0.18,0.82,
Zamboanga City Medical Center GeneXpert Laboratory,2020-05-21,41,41,1,40,0,0,405,0,690,684,117,567,0.17,0.83,
Zamboanga City Medical Center GeneXpert Laboratory,2020-05-22,68,68,2,66,0,0,337,0,758,752,119,633,0.16,0.84,
Zamboanga City Medical Center GeneXpert Laboratory,2020-05-23,7,7,0,7,0,0,330,0,765,759,119,640,0.16,0.84,
Zamboanga City Medical Center GeneXpert Laboratory,2020-05-24,5,5,0,5,0,0,325,0,770,764,119,645,0.16,0.84,
Zamboanga City Medical Center GeneXpert Laboratory,2020-05-25,13,13,0,13,0,0,612,0,783,777,119,658,0.15,0.85,
Zamboanga City Medical Center GeneXpert Laboratory,2020-05-26,11,11,1,10,0,0,601,0,794,788,120,668,0.15,0.85,
Zamboanga City Medical Center GeneXpert Laboratory,2020-05-27,37,37,1,36,0,0,564,0,831,825,121,704,0.15,0.85,
Zamboanga City Medical Center GeneXpert Laboratory,2020-05-28,35,35,0,35,0,0,529,0,866,860,121,739,0.14,0.86,
Zamboanga City Medical Center GeneXpert Laboratory,2020-05-29,28,28,0,28,0,0,500,0,894,888,121,767,0.14,0.86,
Zamboanga City Medical Center GeneXpert Laboratory,2020-05-30,36,36,0,36,0,0,454,0,930,924,121,803,0.13,0.87,
Zamboanga City Medical Center GeneXpert Laboratory,2020-05-31,6,6,0,6,0,0,448,0,936,930,121,809,0.13,0.87,
Zamboanga City Medical Center GeneXpert Laboratory,2020-06-01,43,41,0,41,0,2,403,0,979,971,121,850,0.12,0.88,
Zamboanga City Medical Center GeneXpert Laboratory,2020-06-02,27,27,0,27,0,0,376,0,1006,998,121,877,0.12,0.88,
Zamboanga City Medical Center GeneXpert Laboratory,2020-06-03,39,39,1,38,0,0,336,0,1045,1037,122,915,0.12,0.88,
Zamboanga City Medical Center GeneXpert Laboratory,2020-06-04,56,56,0,56,0,0,278,0,1101,1093,122,971,0.11,0.89,
Zamboanga City Medical Center GeneXpert Laboratory,2020-06-05,45,45,0,45,0,0,232,0,1146,1138,122,1016,0.11,0.89,
Zamboanga City Medical Center GeneXpert Laboratory,2020-06-06,26,26,0,26,0,0,206,0,1172,1164,122,1042,0.1,0.9,
Zamboanga City Medical Center GeneXpert Laboratory,2020-06-07,17,17,0,17,0,0,189,0,1189,1181,122,1059,0.1,0.9,
Zamboanga City Medical Center GeneXpert Laboratory,2020-06-08,16,16,0,16,0,0,173,0,1205,1197,122,1075,0.1,0.9,
Zamboanga City Medical Center GeneXpert Laboratory,2020-06-09,55,55,0,55,0,0,2447,0,1260,1252,122,1130,0.1,0.9,
Zamboanga City Medical Center GeneXpert Laboratory,2020-06-10,96,96,23,73,0,0,2381,0,1356,1348,145,1203,0.11,0.89,
Zamboanga City Medical Center GeneXpert Laboratory,2020-06-11,27,27,1,26,0,0,2354,0,1383,1375,146,1229,0.11,0.89,
Zamboanga City Medical Center GeneXpert Laboratory,2020-06-12,24,24,0,24,0,0,2330,0,1407,1399,146,1253,0.1,0.9,
Zamboanga City Medical Center GeneXpert Laboratory,2020-06-13,56,56,1,55,0,0,2262,0,1463,1455,147,1308,0.1,0.9,
Zamboanga City Medical Center GeneXpert Laboratory,2020-06-14,58,58,1,57,0,0,2204,0,1521,1513,148,1365,0.1,0.9,
Zamboanga City Medical Center GeneXpert Laboratory,2020-06-15,6,6,0,6,0,0,2197,0,1527,1519,148,1371,0.1,0.9,
Zamboanga City Medical Center GeneXpert Laboratory,2020-06-16,48,48,2,46,0,0,2149,0,1575,1567,150,1417,0.1,0.9,
Zamboanga City Medical Center GeneXpert Laboratory,2020-06-17,116,116,1,115,0,0,2033,0,1691,1683,151,1532,0.09,0.91,
Zamboanga City Medical Center GeneXpert Laboratory,2020-06-18,96,96,4,92,0,0,1936,0,1787,1779,155,1624,0.09,0.91,
Zamboanga City Medical Center GeneXpert Laboratory,2020-06-19,96,96,5,91,0,0,1838,0,1883,1875,160,1715,0.09,0.91,
Zamboanga City Medical Center GeneXpert Laboratory,2020-06-20,73,73,3,70,0,0,1765,0,1956,1948,163,1785,0.08,0.92,
Zamboanga City Medical Center GeneXpert Laboratory,2020-06-21,27,27,1,26,0,0,1738,0,1983,1975,164,1811,0.08,0.92,
Zamboanga City Medical Center GeneXpert Laboratory,2020-06-22,42,42,0,42,0,0,1696,0,2025,2017,164,1853,0.08,0.92,
Zamboanga City Medical Center GeneXpert Laboratory,2020-06-23,96,96,8,88,0,0,1599,0,2121,2113,172,1941,0.08,0.92,
Zamboanga City Medical Center GeneXpert Laboratory,2020-06-24,94,94,10,84,0,0,1504,0,2215,2207,182,2025,0.08,0.92,
Zamboanga City Medical Center GeneXpert Laboratory,2020-06-25,45,45,0,45,0,0,1452,0,2260,2252,182,2070,0.08,0.92,
Zamboanga City Medical Center GeneXpert Laboratory,2020-06-26,82,82,3,79,0,0,1370,0,2342,2334,185,2149,0.08,0.92,
Zamboanga City Medical Center GeneXpert Laboratory,2020-06-27,82,82,6,76,0,0,1286,0,2424,2416,191,2225,0.08,0.92,
